僲	亻 覀 舛
儏	亻 粲 
兯	丷 𰆊 
兺	分 叱 
厁	斜 𰆊 
厑	厂 叱 
喸	甫 叱 
嗧	加 侖 
嗭	直 叱 
嗴	口 羗 
嚑	口 熏 
囕	口 覽 
壪	土 彎 
夑	火 言 火 夂 
夞	外 叱 
孧	幼 子 
嵵	山 時 
嶶	山 微 
嶿	山 需 
巪	巨 𠃍 
巬	工 几 夫 
巼	巴 叱 
幉	巾 枼 
幥	巾 掌 
廤	庫 叱 
廭	广 積 
徚	彳 柬 
撶	扌 華 
攚	扌 營 
旕	於 叱 
曢	日 寮 
朑	月 世 
朥	月 勞 
桞	木 邜 
梻	木 佛 
榋	木 彐 彐 彐 
榌	木 飛 
櫊	木 閣 
櫦	木 慶 
櫵	木 蕉 
櫷	木 龜 
欍	木 舊 
欕	木 嚴 
歚	善 欠 
毮	扌 毟 
溊	氵 叚 
溋	氵 盈 
潈	氵 𬑔 
潉	氵 崑 
澚	氵 粵 
澝	氵 甯 
濸	氵 蒼 
濹	氵 墨 
瀭	氵 輸 
炿	火 丿 丹 
熴	火 崑 
燝	火 景 
燞	隹 欠 灬 
爎	火 寮 
爘	火 餐 
爳	爲 了 
猠	犭 典 
獇	犭 羗 
獤	犭 敦 
珯	𤣩 老 
璍	𤣩 華 
癷	癶 干 
磮	石 崙 
礢	石 養 
禣	礻 尃 
稥	禾 ⺣ 日 
穒	禾 鳥 
窧	穴 卓 
篐	竹 𣐝 
簯	竹 棋 
簱	竹 𣄃 
籂	竹 飾 
籎	竹 疑 
籡	竹 撿 
紦	糹 巴 
縇	糹 宣 
縨	糹 晃 
缼	缶 欠 
罀	缶 兆 
艠	舟 登 
茒	艹 邜 
莻	艿 叱 
萙	艹 枕 
萞	艹 𠔿 比 
蒊	花 叱 
蓞	艹 舀 
蔶	艹 責 
薭	艹 稗 
藔	艹 寮 
藵	艹 褒 
蘒	艹 穐 
虄	艹 虫 夂 産 
虅	艹 騰 
螧	虫 耆 
螩	虫 條 
蟵	虫 厨 
蠴	虫 薯 
衐	行 巨 
袰	母 衣 
襅	衤 畢 
襨	衤 對 
覄	覀 伏 
誮	言 花 
謃	言 星 
贌	貝 菐 
贘	貝 賞 
趰	走 爾 
躮	身 分 
躵	身 忍 
躻	身 空 
躼	身 長 
辪	止 𠂤 辛 
鎼	金 𧆠 
鏲	金 牽 
鐢	棥 金 
鐣	金 掌 
鑦	金 賢 
鑧	金 寬 
闎	門 泉 
闏	門 風 
闧	門 遠 
霻	雨 豊 
鱫	魚 愛 
鵇	年 鳥 
鵥	判 鳥 
鶍	易 鳥 
鶎	宗 鳥 
龦	火 常 
龧	日 暑 
龨	匚 隹 
龫	車 𫢉 
龮	馬 翼 
龱	囗 㐅 
龲	金 庫 
龺	十 日 十 
龻	糸 言 糸 
鿃	目 㚒 
鿄	㲽 木 
鿌	氵 亰 
﨩	⻖ 島 
㐜	求 九 
㐝	拘 乙 
㐞	其 乙 
㐟	非 乙 
㐢	浮 乙 
㐣	广 車 乙 
㐥	鋤 乙 
㐦	舉 乙 
㐫	亠 凶 
㐬	𠫓 𫶧 
㐭	亠 回 
㐮	衣 八 𠀎 
㐯	亠 吕 香 
㑅	亻 𠂉 上 
㑎	亻 巛 山 
㑐	亻 尗 
㑨	亻 口 矢 
㑪	亻 斉 
㑮	亻 軍 
㑰	亻 彖 
㑱	亻 柔 
㑳	亻 芻 
㑸	亻 古 可 
㑹	亼 由 曰 
㑺	亻 隽 
㑻	亻 密 
㑼	亻 略 
㑽	亻 堂 
㑾	亻 䚻 
㑿	亻 巢 
㒀	亻 啇 
㒁	亻 圉 
㒂	亻 著 
㒃	亻 貳 
㒄	亻 然 
㒅	亻 袲 
㒆	亻 翕 
㒊	亻 歰 
㒋	亻 斯 
㒌	亻 𤇾 几 
㒍	亻 絫 
㒎	亻 夭 非 
㒐	亻 筍 
㒑	亻 匯 
㒒	亻 業 
㒔	亻 蜀 
㒕	亻 雍 
㒗	亻 䑓 
㒙	亻 綿 
㒚	亻 㥯 
㒛	亻 翟 
㒜	亻 與 
㒝	亻 蔑 
㒞	亻 嶲 
㒟	亻 褭 
㒠	亻 韰 
㒡	亻 繇 
㒤	亻 聶 
㒥	亻 豐 
㒦	亻 壘 
㒧	亻 離 
㒩	亻 蠡 
㒵	白 八 
㒷	𠔿 一 八 
㒸	丷 豕 
㒻	⺜ 見 
㒽	⺜ 卷 
㒾	⺜ 施 
㒿	⺜ 離 
㓂	冖 元 女 
㓃	冖 託 
㓄	參 冘 
㓘	夙 玉 
㓚	工 刂 
㓜	幺 刀 
㓝	井 刂 
㓞	丰 刀 
㓠	占 刂 
㓡	缶 刂 
㓢	各 刂 
㓣	合 刂 
㓧	含 刂 
㓨	夾 刂 
㓩	角 刂 
㓪	良 刂 
㓭	曷 刂 
㓮	周 刂 
㓯	甾 刂 
㓰	画 刂 
㓱	俞 刂 
㓲	扁 刂 
㓳	是 刂 
㓴	耎 刂 
㓵	咢 刂 
㓶	契 刂 
㓷	臬 刂 
㓸	𠁁 刂 
㓹	厂 炎 刂 
㓺	虔 刂 
㓼	桼 刂 
㓽	崇 刂 
㓾	犀 刂 
㔀	景 刂 
㔁	登 刂 
㔂	粦 刂 
㔃	絕 刀 
㔄	粟 刂 
㔅	肅 刂 
㔆	朁 刂 
㔇	發 刂 
㔊	亶 刂 
㔋	監 刂 
㔌	聚 刂 
㔍	算 刂 
㔎	辥 刀 
㔏	磊 刂 
㔑	薛 刀 
㔒	巂 刂 
㔖	加 ㇕ 
㔛	吉 力 
㔜	孚 力 
㔝	兩 力 
㔞	乖 力 
㔠	曷 力 
㔡	𣬉 力 
㔢	絶 力 
㔣	畾 力 
㔤	審 力 
㔥	罷 力 
㔦	養 力 
㔧	盧 力 
㔨	勹 背 
㔪	勹 鹵 
㔭	匕 是 
㔮	𦰩 能 
㔯	匚 㕣 
㔰	匚 外 
㔱	匚 臾 
㔳	匚 飢 
㔴	匚 異 
㔵	匚 巽 
㔶	匚 贛 
㔷	匚 丙 
㔸	匚 虒 
㔺	十 十 十 
㔼	推 十 
㔽	⺊ 回 
㕁	𠫤 卩 
㕏	厂 㪷 
㕐	厂 舄 
㕒	厂 義 
㕖	厽 木 
㕗	羑 厶 
㕘	厽 尒 
㕙	夋 兔 
㕜	中 又 
㕞	𡰯 又 
㕟	⺊ 𠕁 又 
㕠	准 又 
㕡	𣦻 谷 
㕢	𣦻 貝 
㕾	小 叱 
㖁	口 𠫤 
㖐	吅 尹 
㖤	口 函 
㖥	口 囷 
㖦	口 東 
㖧	口 昏 
㖨	口 录 
㖩	口 取 
㖪	口 或 
㖫	口 夌 
㖮	口 侖 
㖾	吅 屰 
㗀	口 幽 
㗁	口 咢 
㗂	口 省 
㗃	口 昬 
㗄	口 𬙙 
㗇	口 叚 
㗈	口 勇 
㗉	㓞 各 
㗋	口 矦 
㗌	口 室 
㗏	口 歪 
㗑	口 拜 
㗒	口 哀 
㗓	口 追 
㗔	口 虔 
㗕	口 冓 
㗖	口 舀 
㗗	另 卑 
㗘	口 尃 
㗙	口 芻 
㗚	口 栗 
㗛	口 笑 
㗜	口 畜 
㗢	口 動 
㗣	口 帶 
㗤	戚 口 
㗥	口 郭 
㗦	口 聊 
㗧	口 窒 
㗨	殹 口 
㗩	口 習 
㗫	口 祭 
㗬	尚 多 
㗭	口 悉 
㗰	口 從 
㗱	口 集 
㗲	口 畫 
㗳	口 答 
㗴	口 閒 
㗵	口 欻 
㗶	口 發 
㗷	口 宀 𠀎 贝 
㗻	口 過 
㗼	口 業 
㗽	鄉 口 
㗿	口 閜 
㘀	口 䊆 
㘁	口 睪 
㘂	口 慈 
㘃	口 惹 
㘄	口 楞 
㘅	口 銜 
㘆	口 臺 
㘇	口 榮 
㘈	口 疑 
㘉	口 節 
㘊	口 霅 
㘋	口 賢 
㘌	口 劇 
㘍	口 𢧵 
㘐	口 駮 
㘑	口 隷 
㘓	口 闌 
㘔	口 賽 
㘕	口 藍 
㘖	口 顏 
㘗	口 瞿 
㘙	口 嚴 
㘚	口 闞 
㘛	口 龕 
㘜	讎 口 
㘤	囗 淵 
㘥	囗 繇 
㙑	禹 土 
㙒	𤰩 土 
㙔	土 韋 
㙙	浝 土 
㙚	土 𦍌 牛 
㙝	土 脅 
㙞	土 臬 
㙟	土 朗 
㙠	殹 土 
㙡	土 從 
㙢	土 㒼 
㙣	土 張 
㙤	土 虖 
㙥	土 袞 
㙨	土 幾 
㙩	土 尞 
㙪	土 壹 
㙫	土 集 
㙬	猌 土 
㙮	土 答 
㙯	埶 云 
㙰	解 土 
㙱	號 土 
㙲	土 雍 
㙳	土 感 
㙴	土 詹 
㙵	土 㙜 
㙷	土 㬎 
㙸	土 僕 
㙹	土 夢 
㙺	土 匱 
㙻	土 廛 
㙼	土 畾 
㙾	土 學 
㚀	土 戲 
㚁	堯 堯 
㚂	土 囊 
㚃	士 冖 䒑 凶 
㚅	夂 一 生 
㚆	𣅀 夂 
㚉	乃 多 
㚊	多 亥 
㚋	多 周 
㚌	多 果 
㚍	多 貴 
㚏	大 廾 
㚒	大 入 入 
㚔	大 𢆉 
㚕	大 弗 
㚛	大 旨 
㚜	大 或 
㚝	大 佳 
㚞	大 林 
㚟	㲋 大 
㚠	大 羔 
㚢	亻 女 
㚤	女 弋 
㚥	女 于 
㚦	女 丌 
㚧	女 广 
㚨	女 卂 
㚩	女 冄 
㚪	女 毛 
㚫	女 及 
㚬	女 匀 
㚭	女 尤 
㚯	女 风 
㚰	女 丕 
㚱	女 丘 
㚲	女 占 
㚴	女 布 
㚵	女 冬 
㚶	女 㠯 
㚷	女 尒 
㚸	女 司 
㚹	女 卯 
㚺	女 孕 
㚻	田 女 
㚼	女 田 
㚽	巧 女 
㚾	女 兄 
㚿	女 包 
㛁	女 平 
㛂	女 𠂬 
㛄	女 衣 
㛅	女 耳 
㛆	女 朶 
㛊	女 朵 
㛍	女 夾 
㛮	女 叜 
㛳	帝 女 
㛴	女 𡿺 
㛵	女 爯 
㛷	𮂱 女 
㜌	𣪊 女 
㜑	浦 女 
㜕	女 連 
㜘	女 虘 
㜛	女 軟 
㜜	女 敖 
㜝	女 酓 
㜞	斬 女 
㜡	女 從 
㜪	新 女 
㜮	女 監 
㜯	女 熙 
㜰	女 樂 
㜱	女 質 
㜲	女 嬴 
㜳	女 褱 
㜴	女 瞢 
㜵	女 褭 
㜶	女 毚 
㜷	彌 女 
㜸	薛 女 
㜹	女 瞿 
㜻	女 戀 
㜼	女 疊 
㜽	巛 子 
㝄	享 屯 
㝈	䜌 孖 
㝛	宀 𠈇 
㝟	宀 一 見 
㝠	宀 昗 
㝡	宀 取 
㝢	宀 禹 
㝣	宀 契 
㝤	宀 冓 
㝥	宀 爿 米 
㝦	宀 隽 
㝧	安 坐 
㝩	宀 康 
㝪	宀 執 
㝫	宀 隆 
㝬	害 夫 
㝭	宀 惺 
㝮	宀 𠭥 
㝯	宀 喬 
㝰	宀 臱 
㝱	𪧇 夢 
㝴	元 寸 
㝵	旦 寸 
㝶	⺫ 儿 寸 
㝸	小 皃 
㝹	少 兔 
㝺	兼 少 
㝻	堇 少 
㝼	尢 于 
㝽	尢 水 
㝾	尢 左 
㝿	尢 皮 
㞀	尢 灰 
㞁	尢 㫐 
㞂	尢 妥 
㞃	谷 尤 
㞄	尢 奄 
㞅	尢 果 
㞆	尢 奇 
㞇	尢 畏 
㞈	尢 扁 
㞉	尢 差 
㞊	祟 尢 
㞋	尸 又 
㞌	尸 子 
㞎	尸 巴 
㞏	尸 乏 
㞐	尸 立 
㞑	尸 ⺢ 
㞒	尸 自 
㞓	尸 旨 
㞔	尸 多 
㞕	尸 八 月 
㞖	尸 朿 
㞘	尸 豖 
㞙	尾 水 
㞚	尸 臿 
㞛	尸 彳 旨 
㞜	尸 㣦 
㞞	尸 從 
㞟	尸 奠 
㞠	尸 尞 
㞡	尸 㠭 𧘇 
㟅	山 兇 
㟗	山 分 分 
㟘	山 周 
㟙	山 昔 
㟚	枝 山 
㟛	山 拑 
㟜	山 弥 
㟝	山 咅 
㟞	山 戔 
㟟	山 共 㔾 
㟠	山 岡 
㟦	山 軍 
㟧	山 咢 
㟨	山 耑 
㟩	敃 山 
㟬	山 叟 
㟺	山 婁 
㟻	斬 山 
㠆	山 單 
㠈	山 閏 
㠉	山 童 
㠊	山 虚 
㠋	山 品 亏 
㠌	山 欺 
㠍	山 集 
㠎	山 集 
㠐	山 喬 
㠑	山 罪 
㠒	山 剽 
㠔	山 辟 
㠕	山 隗 
㠖	山 義 
㠗	山 奧 
㠘	山 與 
㠙	山 豪 
㠚	山 對 
㠛	山 蒦 
㠜	山 疑 
㠝	山 賛 
㠟	山 黎 
㠠	山 盧 
㠡	山 褭 
㠢	嵬 衣 
㠣	山 歷 
㠥	山 壘 
㠦	山 豐 
㠧	山 靡 
㠨	山 欝 
㠪	工 一 
㡃	巾 㠩 
㡄	巾 旬 
㡅	巾 多 
㡆	巾 巟 
㡇	巾 耴 
㡈	巾 免 
㡉	巾 弦 
㡊	巾 臽 
㡋	巾 奄 
㡌	巾 冐 
㡏	巾 俞 
㡑	秋 巾 
㡒	巾 盾 
㡓	巾 軍 
㡔	敄 巾 
㡕	巾 英 
㡖	巾 重 
㡗	巾 虒 
㡘	巾 兼 
㡙	巾 𣬉 
㡚	巾 冓 
㡛	巾 荒 
㡜	巾 祭 
㡝	巾 逢 
㡞	巾 婁 
㡟	巾 曹 
㡠	巾 登 
㡡	巾 厨 
㡢	巾 日 ⺫ 方 
㡥	巾 㥯 
㡦	巾 賓 
㡧	巾 䆸 
㡨	巾 韱 
㡩	䜌 巾 
㡪	巾 𡖀 
㡫	幺 曷 
㡮	幾 气 
㢎	广 臿 
㢏	广 俞 
㢑	广 隼 
㢒	广 虘 
㢓	广 章 
㢔	广 從 
㢖	广 番 
㢗	广 喬 
㢘	广 𠔥 
㢙	广 勤 
㢚	广 虜 
㢛	广 僉 
㢜	广 廿 思 
㢝	广 穌 
㢞	广 翼 
㢟	廴 止 
㢠	廴 冋 
㢡	將 廾 
㢣	敬 廾 
㢼	弓 㡀 
㢽	弓 弭 
㢾	弓 垔 
㣀	弓 真 
㣁	弓 𤰇 
㣂	弓 鬲 
㣃	弓 育 弓 
㣄	弓 渠 
㣅	弓 朁 
㣆	弓 璽 
㣔	彳 丁 
㣙	彳 由 
㣚	彳 同 
㣛	彳 合 
㣜	彳 刑 
㣝	彳 戎 
㣞	彳 八 允 
㣟	彳 吉 
㣠	彳 丨 冬 
㣢	彳 弟 
㣣	彳 㚒 
㣤	彳 戔 
㣥	彳 侍 
㣦	彳 委 
㣧	彳 𦙌 
㣪	彳 爰 
㣫	彳 重 
㣬	彳 咠 
㣭	彳 㚇 
㣯	彳 屑 
㣰	彳 悉 
㣱	彳 責 
㣵	彳 達 
㣶	彳 亶 
㣷	彳 寧 
㣺	忄 丶 
㣻	乂 心 
㣼	忄 刃 
㣽	女 心 
㣾	忄 叉 
㣿	忄 勺 
㤁	天 心 
㤂	及 心 
㤃	忄 方 
㤄	忄 巿 
㤅	旡 心 
㤆	忄 反 
㤒	忄 夲 
㤓	忄 本 
㤔	忄 付 
㤕	忄 出 
㤖	忄 宁 
㤚	忄 行 
㤛	忄 任 
㤜	忄 戍 
㤝	忄 充 
㤞	忄 宅 
㤟	曲 心 
㤠	列 心 
㤡	忄 列 
㤢	忄 有 
㤥	忄 亥 
㤦	忄 吏 
㤧	忄 后 
㤨	忄 共 
㤩	各 心 
㤪	一 怨 
㤫	有 心 
㤬	忄 圭 
㤮	狂 心 
㤯	忄 冏 
㤰	作 心 
㤱	忄 豆 
㤲	夾 心 
㤳	忄 否 
㤴	忄 耴 
㤵	孜 心 
㤶	忄 尨 
㤷	忄 含 
㤸	忄 赤 
㤹	忄 求 
㤺	忄 巟 
㤽	忄 寿 
㤾	忄 罙 
㤿	忄 奄 
㥀	忄 直 
㥁	𠃊 十 ⺫ 心 
㥂	忄 㝵 
㥅	忄 受 
㥆	忄 隶 
㥇	忄 戔 
㥈	帖 心 
㥉	忄 咅 
㥊	忄 朋 
㥋	依 心 
㥌	忄 匊 
㥍	忄 其 
㥎	𥝢 心 
㥏	忄 典 
㥐	命 心 
㥒	忄 采 
㥓	忄 奇 
㥔	忄 育 
㥕	炎 心 
㥖	丹 忩 
㥚	忄 臾 
㥛	忄 亟 
㥜	忄 胃 
㥝	忄 弭 
㥞	忄 㒸 
㥟	忄 彖 
㥠	忄 胥 
㥡	忄 𣐉 
㥢	忄 酋 
㥣	奎 心 
㥥	忄 禺 
㥦	匧 心 
㥧	忄 頁 
㥨	娃 心 
㥩	忄 者 
㥫	忄 亯 
㥬	忄 旁 
㥭	忄 泰 
㥮	忄 芻 
㥰	忄 叟 
㥱	忄 匪 
㥲	真 心 
㥳	忄 原 
㥴	忄 虒 
㥵	忄 圂 
㥶	𡨄 心 
㥷	广 㤲 
㥸	民 思 
㥹	粉 心 
㥺	忄 盍 
㥼	忄 焉 
㥽	忄 責 
㥾	忄 匿 
㥿	敖 心 
㦀	忄 逢 
㦁	連 心 
㦂	常 心 
㦃	忄 産 
㦄	麻 心 
㦅	忄 帶 
㦆	忄 虖 
㦇	忄 鹿 
㦉	忄 壹 
㦊	忄 華 
㦋	忄 奢 
㦌	毳 心 
㦍	忄 㖾 
㦎	忄 畫 
㦏	忄 巽 
㦑	忄 敢 
㦒	忄 詈 
㦓	忄 然 
㦔	猒 心 
㦕	忄 隆 
㦖	忄 悶 
㦗	忄 禁 
㦘	敫 心 
㦚	辛 心 辛 
㦛	與 心 
㦜	忄 蒦 
㦝	貌 心 
㦞	壽 心 
㦟	貍 心 
㦡	忄 樂 
㦢	忄 節 
㦣	衛 心 
㦤	壹 欠 心 
㦥	忄 憲 
㦦	忄 䦧 
㦧	忄 㬱 
㦨	忄 闌 
㦩	忄 隱 
㦪	忄 燮 
㦫	忄 贊 
㦬	忄 羅 
㦭	忄 靈 
㦯	戈 厶 一 
㦰	戈 从 
㦵	朱 戈 
㦶	戈 至 
㦷	甬 戈 
㦸	卓 戈 
㦹	昜 戈 
㦺	辱 戈 
㦻	習 戈 
㦼	舂 戈 
㦽	有 𡿿 
㦾	户 也 
㦿	户 木 
㧀	户 及 
㧁	户 去 
㧂	户 田 
㧃	扌 丩 
㧄	扌 凵 
㧅	扌 刀 
㧆	扌 巾 
㧇	扌 𠔼 
㧈	扌 弓 
㧉	扌 气 
㧊	扌 巿 
㧋	扌 犬 
㧌	扌 毛 
㧍	扌 方 
㧎	扌 牙 
㧏	扌 冈 
㧒	扌 穴 
㧓	扌 瓜 
㧔	扌 戊 
㧕	扌 卯 
㧖	扌 戹 
㧗	扌 此 
㧘	此 手 
㧙	扌 必 
㧚	扌 瓦 
㧜	扌 匝 
㧡	扌 亥 
㧢	扌 因 
㧣	扌 朱 
㧤	扌 充 
㧥	扌 先 
㧦	扌 旬 
㧨	扌 后 
㧩	扌 𫥞 
㧪	扌 危 
㧫	扌 而 
㧭	邛 手 
㧮	扌 臼 
㧯	扌 老 
㧰	扌 乐 
㧱	合 手 
㧲	扌 宋 
㧳	扮 手 
㧴	扌 我 
㧶	扌 身 
㧷	扌 吞 
㧸	扌 亨 
㨂	扌 東 
㨖	扌 致 
㨙	扌 奚 
㨚	扌 荀 
㨛	扌 閃 
㨜	扌 虔 
㨝	扌 屑 
㨞	扌 素 
㨟	扌 豈 
㨠	扌 冥 
㨡	扌 圂 
㨤	扌 龨 
㨦	扌 隻 
㨧	扌 畚 
㨨	扌 留 
㨩	扌 庭 
㨪	扌 晃 
㨫	扌 监 
㨭	扌 扈 
㨮	扌 兜 
㨯	扌 郭 
㨰	扌 衮 
㨱	扌 䚻 
㨲	扌 艹 宋 
㨳	扌 寄 
㨴	扌 乾 
㨵	扌 剪 
㨶	扌 鳥 
㨷	扌 堇 
㨸	扌 密 
㨹	扌 彗 
㨺	扌 㒼 
㨻	斬 手 
㨼	略 手 
㨽	扌 副 
㨾	扌 羕 
㨿	扌 處 
㩀	扌 䖏 
㩁	扌 寉 
㩃	扌 寒 
㩄	扌 崽 
㩅	扌 畱 
㩆	扌 就 
㩇	扌 畫 
㩈	扌 窘 
㩉	扌 翕 
㩊	扌 𡬳 
㩋	扌 肅 
㩌	扌 費 
㩍	扌 策 
㩎	扌 猒 
㩐	扌 等 
㩓	毀 手 
㩔	扌 殿 
㩖	扌 畺 
㩘	扌 義 
㩙	扌 塞 
㩚	扌 蒙 
㩛	扌 團 
㩜	扌 監 
㩝	扌 豪 
㩞	扌 榮 
㩟	扌 寨 
㩠	扌 麃 
㩡	扌 磊 
㩢	扌 蔑 
㩤	扌 敷 
㩦	扌 隹 冏 
㩨	扌 慧 
㩩	扌 潁 
㩪	扌 䋶 
㩭	扌 學 
㩮	扌 擧 
㩯	扌 繁 
㩰	扌 艹 喿 
㩱	扌 爵 
㩲	扌 雚 
㩳	扌 雙 
㩴	扌 瞿 
㩶	扌 竹 爾 
㩷	扌 騫 
㩸	扌 畾 宐 
㩹	扌 畾 冝 
㩼	多 支 
㩽	束 支 
㩾	垂 支 
㩿	乞 攵 
㪀	于 攵 
㪁	今 攴 
㪂	气 攴 
㪃	可 攴 
㪄	弗 攵 
㪅	丙 攴 
㪆	氐 攴 
㪇	先 攵 
㪈	圭 攴 
㪉	合 攵 
㪊	君 攴 
㪋	旱 攴 
㪌	甬 攴 
㪍	孛 攵 
㪎	夾 攴 
㪏	卑 攴 
㪐	戾 攴 
㪑	奄 攴 
㪒	兒 攴 
㪓	乖 攴 
㪔	林 攴 
㪕	卓 攴 
㪖	录 攴 
㪗	咅 攴 
㪘	㑒 攵 
㪙	果 攵 
㪚	龷 攵 日 
㪛	甚 攴 
㪜	耑 攴 
㪝	柬 攴 
㪞	冒 攴 
㪠	兼 攴 
㪡	害 攴 
㪢	叟 攴 
㪣	高 攵 
㪤	畢 攵 
㪥	虘 攴 
㪦	寅 攵 
㪧	翕 攴 
㪨	善 攴 
㪩	肅 攴 
㪪	䨿 攴 
㪫	睿 攴 
㪬	翟 攴 
㪭	盧 攴 
㪮	霝 攴 
㪯	文 𰀁 
㪱	文 奂 
㪴	元 斗 
㪵	半 斗 
㪶	百 斗 
㪷	豆 斗 
㪹	婁 斗 
㪺	𥇛 斗 
㪻	䜌 斗 
㪼	可 斤 
㪽	一 昕 
㪾	各 斤 
㪿	屮 屮 斤 
㫀	昌 斤 
㫁	𠃊 𢆶 兀 斤 
㫂	庶 斤 
㫃	方 人 
㫄	二 勹 方 
㫅	㫃 亓 
㫊	𭤨 可 
㫍	𭤨 攸 
㫎	方 軍 
㫏	𭤨 要 
㫐	日 匕 
㫑	日 力 
㫒	日 廾 
㫓	日 乞 
㫔	日 上 
㫖	上 日 
㫗	曰 子 
㫘	不 日 
㫙	日 夫 
㫚	勿 曰 
㫛	日 兄 
㫜	日 旦 
㫝	日 氐 
㫟	日 㕣 
㫠	日 半 
㫢	日 去 
㫤	旦 永 
㫥	日 名 
㫦	攸 日 
㫧	日 米 
㫨	日 安 
㫫	日 亚 
㫭	日 寺 
㫯	昌 兀 
㫱	日 赤 
㫲	日 孛 
㫳	辰 日 
㫵	日 非 
㫶	日 帚 
㫷	其 日 
㫸	日 疌 
㫹	日 所 
㫻	日 侖 
㫼	日 制 
㫽	日 录 
㬂	日 禺 
㬃	日 炱 
㬄	日 厂 赤 
㬅	日 ⺫ 万 
㬆	日 昬 
㬇	日 奂 
㬈	日 昷 
㬉	日 耎 
㬋	日 侯 
㬍	日 尃 
㬏	日 鬲 
㬐	日 晋 
㬒	日 莽 
㬓	日 票 
㬔	日 翏 
㬕	日 祥 
㬗	日 然 
㬘	日 肅 
㬙	日 爲 
㬛	日 翕 
㬝	日 曾 
㬞	日 山 曷 
㬟	勿 曾 
㬠	日 煞 
㬡	日 零 
㬢	日 義 
㬣	日 對 
㬤	日 㬎 
㬦	日 蒦 
㬩	日 慧 
㬪	晶 宐 
㬫	燕 日 
㬬	日 瞿 
㬭	日 爵 
㬮	日 難 
㬯	日 羸 
㬰	由 人 
㬱	兟 曰 
㬲	更 益 
㬳	月 午 
㬴	月 共 
㬵	月 交 
㬶	月 告 
㬸	月 花 
㬻	月 荒 
㬼	有 复 
㬿	月 敦 
㭁	木 乃 
㭂	木 小 
㭄	木 卂 
㭇	木 允 
㭈	木 夬 
㭉	艹 木 
㭋	木 丰 
㭌	木 牛 
㭑	木 未 
㭒	木 㠯 
㭓	木 弁 
㭔	木 乎 
㭘	木 合 
㭙	木 寺 
㭛	木 𠂢 
㭜	木 戎 
㭝	林 九 
㭞	木 劣 
㭟	共 木 
㭠	木 先 
㭡	木 囟 
㭢	木 刑 
㭤	木 鸟 
㭨	木 邪 
㭩	木 寽 
㭪	木 甫 
㭫	木 坐 
㭬	木 豕 
㭭	木 別 
㭮	木 𣧄 
㭯	木 耴 
㭰	此 朿 
㭱	木 匣 
㭲	木 谷 
㭴	木 坚 
㭸	木 兔 
㭹	木 弦 
㭺	木 奄 
㭻	木 尚 
㭼	木 沓 
㭽	木 底 
㭾	木 屈 
㭿	木 昂 
㮀	木 函 
㮁	木 肴 
㮂	𰥍 木 
㮃	木 委 
㮄	木 㫄 
㮅	木 隹 
㮆	木 𠆢 羊 
㮇	木 忝 
㮈	木 奈 
㮋	木 郁 
㮌	木 面 
㮏	木 柰 
㮐	木 省 
㮑	木 臿 
㮒	木 垔 
㮓	木 恆 
㮔	木 重 
㮕	木 耎 
㮖	木 革 
㮗	矜 木 
㮘	木 敄 
㮙	木 咢 
㮚	𠧪 木 
㮛	木 是 
㮜	木 匨 
㮝	木 卻 
㮞	木 咨 
㮟	柘 木 
㮡	炬 木 
㮢	木 侯 
㮣	既 木 
㮥	木 畚 
㮦	木 索 
㮧	木 烏 
㮨	木 畟 
㮩	木 息 
㮪	木 𣑦 
㮫	木 害 
㮬	木 翁 
㮭	木 圅 
㮮	木 挈 
㮯	木 圂 
㮰	木 𣬉 
㮱	木 艹 先 
㮲	木 芻 
㮳	木 朕 
㮵	木 旃 
㮶	木 朔 
㮷	木 尤 旨 
㮸	木 送 
㮹	木 致 
㮺	本 𠱠 
㮿	木 畢 
㯀	木 旋 
㯁	木 陪 
㯂	木 帶 
㯃	木 桼 
㯄	林 巵 
㯅	木 庳 
㯆	木 産 
㯇	木 𡌦 
㯈	木 速 
㯉	木 虖 
㯊	木 焉 
㯋	匕 木 頁 
㯌	木 逐 
㯍	木 將 
㯎	木 言 木 
㯏	殸 木 
㯐	隋 木 
㯓	木 翕 
㯔	毳 木 
㯕	木 斯 
㯖	木 𢛳 
㯗	木 閑 
㯘	木 款 
㯙	木 𰕎 
㯚	木 答 
㯛	木 壺 
㯜	木 萃 
㯝	木 路 
㯞	木 絹 
㯟	林 彔 
㯠	木 牽 
㯡	桼 包 
㯢	木 巽 
㯦	木 其 木 
㯩	桑 夷 
㯪	木 零 
㯫	木 豦 
㯬	林 建 
㯭	木 虜 
㯮	木 蜀 
㯰	木 置 
㯲	木 禁 
㯳	木 敬 
㯶	木 𡕰 
㯷	木 僕 
㯸	木 盡 
㯹	木 𡬽 
㯺	𰯲 木 
㯽	木 賔 
㯾	木 遭 
㯿	木 巤 
㰁	木 磊 
㰂	木 審 
㰃	木 緜 
㰄	木 賤 
㰅	木 適 
㰆	𰀉 冖 棐 
㰈	林 連 
㰊	木 燅 
㰋	木 頻 
㰌	木 霍 
㰍	龍 木 
㰎	木 嶲 
㰐	木 隨 
㰑	木 橤 
㰒	木 學 
㰔	木 燮 
㰕	木 羲 
㰖	木 覧 
㰗	木 蹙 
㰘	木 彝 
㰙	木 難 
㰚	木 離 
㰛	木 藥 
㰝	巳 欠 
㰞	山 欠 
㰟	气 欠 
㰠	亢 欠 
㰡	介 欠 
㰢	开 欠 
㰣	此 欠 
㰤	可 欠 
㰥	世 欠 
㰦	去 欠 
㰧	台 欠 
㰨	只 欠 
㰩	虫 欠 
㰪	圭 欠 
㰫	先 欠 
㰬	旬 欠 
㰭	夸 欠 
㰮	辰 欠 
㰯	豆 欠 
㰰	夾 欠 
㰱	𢆍 欠 
㰲	或 欠 
㰳	亞 欠 
㰴	咅 欠 
㰵	卒 欠 
㰶	咎 欠 
㰷	死 欠 
㰸	㑒 欠 
㰹	咸 欠 
㰺	叚 欠 
㰼	匧 欠 
㰽	匽 欠 
㰿	奚 欠 
㱀	芻 欠 
㱁	祟 欠 
㱂	康 欠 
㱃	酓 欠 
㱄	黑 欠 
㱅	壹 欠 
㱆	䖒 欠 
㱇	嗇 欠 
㱈	禁 欠 
㱉	業 欠 
㱊	憂 欠 
㱋	霍 欠 
㱌	聶 欠 
㱍	䜌 欠 
㱎	𣣴 魚 
㱏	二 止 
㱔	此 夕 
㱖	止 卒 
㱗	止 臭 
㱘	厭 止 
㱙	歹 丂 
㱚	歹 ⺼ 
㱛	歹 歹 
㱜	歹 龰 
㱞	歹 立 
㱟	歹 皮 
㱠	歹 古 
㱡	歹 先 
㱢	歹 良 
㱣	歹 妥 
㱤	歹 析 
㱥	歹 夌 
㱧	歹 宛 
㱨	歹 定 
㱪	歹 昬 
㱫	歹 柬 
㱬	歹 畏 
㱭	歹 段 
㱯	歹 豈 
㱰	歹 宰 
㱱	歹 鬼 
㱲	歹 益 
㱳	莫 歹 
㱴	歹 責 
㱵	歹 賁 
㱶	歹 彭 
㱸	歹 辟 
㱹	歹 歷 
㱺	歹 盧 
㱻	歹 羸 
㱼	巳 殳 
㱽	冘 殳 
㱾	亥 殳 
㱿	士 𠔼 殳 
㲀	辰 殳 
㲁	空 殳 
㲂	尚 殳 
㲃	𠧢 殳 
㲄	士 冖 王 殳 
㲅	害 殳 
㲆	殸 令 
㲈	殸 召 
㲉	𣪊 卵 
㲌	毛 乃 
㲍	支 毛 
㲏	片 毛 
㲒	句 毛 
㲓	毛 戍 
㲔	辛 毛 
㲕	寽 毛 
㲖	肖 毛 
㲗	孚 毛 
㲘	貝 毛 
㲚	沙 毛 
㲛	知 毛 
㲜	炎 毛 
㲝	毛 隹 
㲞	卒 毛 
㲟	英 毛 
㲠	未 攵 毛 
㲡	柰 毛 
㲢	扁 毛 
㲤	衰 毛 
㲥	唐 毛 
㲦	𠦝 𠆢 毛 
㲧	毛 蚤 
㲨	茸 毛 
㲪	登 毛 
㲫	菐 毛 
㲬	焦 毛 
㲭	焱 毛 
㲯	監 毛 
㲰	寧 毛 
㲱	毛 巤 
㲲	疊 毛 
㲳	氐 失 
㲴	气 中 
㲶	气 鹵 
㲷	气 單 
㲸	氵 乙 
㲹	氵 几 
㲺	氵 七 
㲻	亻 水 
㲼	氵 乂 
㲽	氵 刃 
㲾	宀 水 
㳀	氵 戈 
㳁	氵 仄 
㳂	氵 公 
㳃	氵 卆 
㳄	氵 欠 
㳅	氵 不 
㳆	氵 斗 
㳈	氵 𣎳 
㳊	氵 攵 
㳋	氵 丘 
㳌	氵 甲 
㳍	氵 布 
㳎	氵 弁 
㳏	氵 史 
㳐	氵 札 
㳑	氵 皿 
㳒	氵 厺 
㳔	氵 对 
㳖	氵 衣 
㳗	氵 叉 土 
㳙	氵 䏍 
㳛	氵 臾 
㳜	氵 休 
㳡	氵 过 
㳥	氵 弄 
㳦	氵 戒 
㳧	氵 耴 
㳨	氵 𣧄 
㳩	江 丹 
㳪	氵 否 
㳫	水 臼 
㳬	氵 𭻾 
㳭	氵 呆 
㳮	氵 尿 
㳴	氵 𡊭 
㳵	氵 季 
㳶	氵 乳 
㳷	氵 曶 
㳸	氵 花 
㳹	氵 枉 
㳻	氵 昔 
㳼	或 水 
㳽	氵 弥 
㳾	氵 羌 
㳿	氵 𣏋 
㴀	氵 艹 乏 
㴁	氵 夭 井 
㴂	江 冉 
㴃	氵 户 水 
㴄	氵 囧 
㴆	氵 帚 
㴈	氵 岳 
㴉	氵 厽 二 
㴎	氵 奈 
㴏	氵 穴 王 
㴐	氵 眄 
㴑	氵 㡿 
㴒	氵 弈 
㴓	氵 思 
㴕	氵 艹 禾 
㴗	氵 要 
㴘	氵 冒 
㴙	氵 臿 
㴚	氵 㒸 
㴛	氵 致 
㴜	氵 扁 
㴝	利 𠆢 水 
㴥	氵 峭 
㴦	氵 宮 
㴧	氵 息 
㴨	氵 朕 
㴩	氵 邕 
㴪	氵 臬 
㴫	氵 郡 
㴬	氵 射 
㴭	氵 窅 
㴮	氵 屑 
㴯	氵 脂 
㴰	氵 能 
㴲	氵 虒 
㴳	氵 土 尨 
㴴	氵 𠃊 火 𠃊 火 
㴵	氵 𥁑 
㴶	氵 隺 
㴷	氵 耽 
㴸	氵 閃 
㴼	氵 宿 
㴽	氵 悉 
㴾	浡 攵 
㴿	氵 頂 
㵀	氵 族 
㵂	氵 庶 
㵃	氵 蛇 
㵄	氵 或 天 
㵅	氵 貪 
㵆	汨 告 
㵊	氵 最 
㵋	氵 買 
㵌	氵 循 
㵍	氵 悶 
㵎	氵 閒 
㵏	氵 萃 
㵑	氵 賀 
㵒	氵 費 
㵓	氵 寔 
㵔	氵 奢 
㵕	氵 叅 
㵖	氵 絮 
㵗	馮 水 
㵝	氵 裔 
㵞	氵 愁 
㵠	氵 窟 
㵡	氵 雹 
㵢	氵 雷 
㵣	氵 歇 
㵤	氵 翜 
㵥	氵 䀄 
㵦	氵 遀 
㵧	氵 葛 
㵨	辟 水 
㵩	氵 葉 
㵪	氵 羨 
㵫	氵 孴 
㵬	氵 月 盈 
㵭	氵 煮 
㵯	氵 鳳 
㵰	氵 與 
㵱	漂 寸 
㵲	氵 舞 
㵳	氵 寥 
㵴	氵 臧 
㵵	氵 聚 
㵶	氵 截 
㵷	辛 氵 辛 
㵸	氵 𠎤 
㵹	汕 莫 
㵺	氵 箄 
㵻	氵 月 叟 
㵼	氵 冩 
㵽	氵 畾 
㵾	氵 靚 
㵿	氵 皛 
㶀	氵 膠 
㶁	氵 虢 
㶄	氵 閻 
㶅	氵 學 
㶆	氵 諸 
㶇	氵 横 
㶈	氵 螢 
㶌	氵 聯 
㶍	氵 鮮 
㶎	氵 還 
㶏	氵 隱 
㶑	氵 歛 
㶒	氵 闖 
㶓	氵 藏 
㶔	氵 奰 
㶕	氵 簡 
㶖	氵 儵 
㶗	䋣 泉 
㶘	氵 簟 
㶚	氵 覇 
㶛	氵 旟 
㶞	氵 曩 
㶟	氵 纍 
㶠	氵 驛 
㶡	⺇ 火 
㶣	干 火 
㶤	火 夕 
㶥	火 干 
㶦	火 予 
㶧	火 内 
㶫	𡗜 火 
㶬	火 末 
㶭	火 幼 
㶯	火 卯 
㶰	火 甘 
㶴	火 多 
㶵	任 灬 
㶹	火 汞 
㶺	火 吞 
㶼	火 矣 
㶾	𧟡 火 
㶿	火 孛 
㷀	炏 卂 
㷂	臤 火 
㷃	火 長 
㷄	火 果 
㷅	取 火 
㷆	火 阜 
㷇	多 灰 
㷈	火 奄 
㷉	尸 二 火 寸 
㷊	林 灬 
㷍	火 侖 
㷎	火 曷 
㷏	禾 午 火 
㷒	火 禺 
㷓	火 怱 
㷕	酋 火 
㷖	炅 召 
㷗	丿 㠯 巳 火 
㷘	火 枲 
㷟	火 追 
㷠	炎 舛 
㷡	𥄷 火 
㷢	差 火 
㷣	火 𦍌 牛 
㷤	𣪊 火 
㷦	耿 灬 
㷩	丿 臣 巳 火 
㷪	火 隽 
㷬	火 莫 
㷭	逢 火 
㷮	火 曹 
㷯	火 土 奉 
㷳	雁 火 
㷴	厤 火 
㷵	火 黑 
㷶	備 灬 
㷷	火 巽 
㷸	火 𬀽 
㷹	火 䓬 
㷻	火 無 
㷼	廿 北 口 火 
㷾	火 豦 
㷿	火 僉 
㸀	火 㙜 
㸁	火 業 
㸃	黑 占 
㸄	火 齊 
㸅	火 節 
㸇	火 賛 
㸉	火 辛 火 火 
㸊	火 賴 
㸋	炙 番 
㸍	火 戲 
㸎	火 聶 
㸏	靡 火 
㸐	難 灬 
㸑	𦥑 同 焚 
㸒	爫 壬 
㸓	爫 日 
㸔	𠂟 目 
㸕	爪 隻 
㸖	父 且 
㸗	父 同 
㸘	父 罒 丁 
㸙	父 者 
㸛	爿 召 
㸜	爿 空 
㸝	片 欠 
㸟	片 旨 
㸠	片 兆 
㸡	片 朱 
㸢	片 𤰇 
㸣	片 業 
㸤	辛 片 辛 
㸥	片 毚 
㸧	牙 艮 
㸨	牜 丩 
㸩	牜 干 
㸪	牜 川 
㸫	牜 斤 
㸬	牜 巿 
㸭	牜 巴 
㸮	牜 分 
㸯	牜 斗 
㸰	牜 它 
㸱	牜 㐌 
㸲	牜 乍 
㸳	牜 令 
㸵	牜 吉 
㸶	牜 因 
㸷	㓞 牛 
㸹	牜 寽 
㸺	沙 牛 
㸻	牜 矣 
㸽	牜 貝 
㸾	牜 忍 
㸿	牜 壳 
㹀	牜 孛 
㹁	牜 京 
㹂	臤 牛 
㹄	牜 畟 
㹅	牜 怱 
㹆	牜 軍 
㹇	牜 曷 
㹈	未 攵 牛 
㹉	牜 原 
㹊	牜 隺 
㹋	牜 修 
㹌	牜 產 
㹍	牜 啇 
㹎	牜 累 
㹏	牜 堇 
㹐	從 牛 
㹑	牜 貳 
㹒	牜 菐 
㹓	牜 堯 
㹔	牜 畺 
㹕	頑 牛 
㹖	牜 豢 
㹗	牜 壽 
㹘	牜 需 
㹙	牜 𤇾 目 
㹚	牜 營 
㹛	牜 夒 
㹝	犭 氏 
㹞	犭 斤 
㹟	犭 夬 
㹠	犭 屯 
㹡	犭 玄 
㹢	犭 加 
㹣	犭 冬 
㹤	犭 去 
㹥	犭 主 
㹦	犭 召 
㹨	犭 由 
㹫	犭 夷 
㹬	犭 吏 
㹭	犭 曳 
㹮	犭 百 
㹱	犭 足 
㹲	犭 孝 
㹳	犭 吾 
㹵	犭 巠 
㹶	犭 廷 
㹷	希 犬 
㹸	犭 皃 
㹹	犭 庚 
㹺	犭 沓 
㹻	犭 委 
㹼	犭 匊 
㹽	犭 戔 
㹾	犭 咎 
㹿	犭 卓 
㺀	犭 忽 
㺁	犭 𡿺 
㺂	犭 咸 
㺃	犭 苟 
㺅	犭 矦 
㺇	犭 𦣞 犬 
㺈	犭 蚩 
㺉	𣪊 犬 
㺊	犭 恙 
㺋	犭 翁 
㺌	犭 兼 
㺎	犭 庸 
㺏	犭 婁 
㺐	犭 巢 
㺑	犭 參 
㺒	犭 翏 
㺓	犬 責 
㺔	犭 爲 
㺕	犭 番 
㺖	犭 敢 
㺗	犭 單 
㺘	犭 焦 
㺚	犭 達 
㺛	犭 馵 
㺜	犭 農 
㺝	犭 監 
㺞	犭 與 
㺟	犭 翟 
㺠	犭 窳 
㺡	犭 歷 
㺢	犭 霍 
㺣	犭 戲 
㺤	犭 韱 
㺥	犭 毚 
㺦	犭 聯 
㺨	𤣩 厶 
㺩	𤣩 丩 
㺪	𤣩 卜 
㺫	𤣩 刂 
㺬	𤣩 凡 
㺭	𤣩 子 
㺮	𤣩 亏 
㺱	仍 玉 
㺲	𤣩 丑 
㺳	𤣩 攴 
㺴	𤣩 犬 
㺵	𤣩 欠 
㺷	𤣩 术 
㺸	𠆩 玉 
㺹	𤣩 弁 
㺺	𤣩 目 
㺿	𤣩 𦣞 
㻂	𤣩 并 
㻃	曲 玉 
㻄	𤣩 丿 𤴓 
㻅	𤣩 会 
㻉	𤣩 步 
㻊	𤣩 免 
㻋	𤣩 束 
㻌	𤣩 余 
㻍	𤣩 吴 
㻎	大 玨 
㻏	𤣩 灵 
㻑	𤣩 季 
㻒	𤣩 囷 
㻓	𤣩 取 
㻔	𤣩 垂 
㻕	𤣩 屈 
㻖	𤣩 隶 
㻗	非 玉 
㻝	𤣩 剌 
㻠	𤣩 突 
㻡	𤣩 枼 
㻧	𤣩 桀 
㻪	𤣩 隽 
㻫	𤣩 畢 
㻭	𤣩 率 
㻮	𤣩 祭 
㻯	𤣩 虖 
㻰	𤣩 彗 
㻱	𤣩 逢 
㻲	𤣩 婁 
㻵	𤣩 孱 
㻶	𤣩 筆 
㻷	𤣩 棘 
㻸	𤣩 朁 
㻹	石 豕 玉 
㻺	厤 玉 
㻽	𤣩 雋 
㻾	雍 玉 
㻿	𤣩 蜀 
㼆	𤣩 瑩 
㼇	𤣩 嶲 
㼈	𤣩 羅 
㼉	瓜 冘 
㼊	屯 瓜 
㼋	古 瓜 
㼍	耒 瓜 
㼎	瓜 交 
㼏	妥 瓜 
㼐	扁 瓜 
㼑	柬 瓜 
㼒	瓜 昜 
㼓	瓜 兼 
㼔	昷 瓜 
㼕	當 瓜 
㼖	瓜 蠡 
㼗	丁 瓦 
㼘	山 瓦 
㼙	巾 瓦 
㼚	亢 瓦 
㼛	开 瓦 
㼜	央 瓦 
㼝	夗 瓦 
㼞	平 瓦 
㼟	白 瓦 
㼠	它 瓦 
㼡	朱 瓦 
㼢	𦣞 瓦 
㼣	百 瓦 
㼤	㓞 瓦 
㼥	考 瓦 
㼦	巩 瓦 
㼧	甬 瓦 
㼨	含 瓦 
㼩	成 瓦 
㼪	夾 瓦 
㼫	果 瓦 
㼬	幸 瓦 
㼭	坫 瓦 
㼮	妻 瓦 
㼯	東 瓦 
㼰	卑 瓦 
㼱	北 㓁 瓦 
㼲	耎 瓦 
㼳	省 瓦 
㼴	禺 瓦 
㼵	是 瓦 
㼶	俞 瓦 
㼷	耑 瓦 
㼸	容 瓦 
㼹	荒 瓦 
㼺	唐 瓦 
㼻	從 瓦 
㼼	票 瓦 
㼽	爽 瓦 
㼾	鹿 瓦 
㼿	童 瓦 
㽀	奠 瓦 
㽁	厤 瓦 
㽂	翕 瓦 
㽃	番 瓦 
㽄	斯 瓦 
㽆	當 瓦 
㽇	𦥯 瓦 
㽈	疑 瓦 
㽉	𰯲 瓦 
㽊	燮 瓦 
㽋	䜌 瓦 
㽌	霤 瓦 
㽎	甚 冘 
㽑	甘 覃 
㽕	由 𢎘 
㽖	田 力 
㽘	田 亢 
㽙	田 允 
㽚	田 牛 
㽛	田 句 
㽜	夗 田 
㽝	列 田 
㽞	吅 田 
㽟	田 寽 
㽠	田 夾 
㽡	田 卑 
㽢	田 奄 
㽣	田 或 
㽤	田 匊 
㽥	田 柔 
㽦	𤇾 田 
㽧	田 兹 
㽨	田 差 
㽩	田 參 
㽪	田 曾 
㽫	雍 田 
㽭	田 需 
㽯	田 巂 
㽰	朋 疋 
㽱	疒 丩 
㽲	疒 丂 
㽳	疒 于 
㽴	疒 丈 
㽷	疒 水 
㽸	疒 冘 
㽹	疒 反 
㽺	疒 及 
㽻	疒 支 
㽽	疒 古 
㽾	疒 出 
㾀	疒 去 
㾁	疒 术 
㾂	疒 台 
㾃	疒 它 
㾄	疒 由 
㾅	疒 𠂔 
㾆	疒 冉 
㾇	疒 目 
㾈	疒 付 
㾉	疒 令 
㾊	疒 朿 
㾋	疒 休 
㾌	疒 先 
㾍	疒 而 
㾎	疒 凹 
㾏	疒 圭 
㾐	疒 列 
㾑	疒 合 
㾒	疒 如 
㾓	疒 肙 
㾔	疒 吕 
㾕	疒 辛 
㾖	疒 里 
㾗	疒 良 
㾘	疒 更 
㾙	疒 希 
㾚	疒 些 
㾛	疒 𠬶 
㾜	疒 夾 
㾝	疒 車 
㾞	疒 酉 
㾟	疒 步 
㾠	疒 狂 
㾡	疒 却 
㾢	疒 來 
㾣	疒 金 
㾤	疒 空 
㾥	疒 叔 
㾦	疒 咅 
㾧	疒 果 
㾨	疒 奇 
㾩	疒 乖 
㾪	疒 省 
㾫	疒 扁 
㾭	疒 秋 
㾮	疒 皇 
㾯	疒 畏 
㾰	疒 胡 
㾱	疒 発 
㾴	疒 查 
㾵	疒 計 
㾶	疒 骨 
㾷	疒 虒 
㾸	疒 高 
㾹	疒 柴 
㾺	疒 馬 
㾻	疒 除 
㾼	疒 退 
㾽	疒 追 
㾾	疒 兼 
㾿	疒 郎 
㿃	疒 帶 
㿄	疒 殹 
㿅	疒 徙 
㿆	疒 禾 衣 
㿇	疒 習 
㿉	疒 貴 
㿊	疒 朁 
㿋	疒 喿 
㿌	疒 僉 
㿍	疒 解 
㿎	疒 賁 
㿏	疒 羣 
㿑	疒 翟 
㿒	疒 壽 
㿓	疒 夾 足 
㿔	疒 畾 
㿕	疒 閻 
㿖	疒 盧 
㿗	疒 頹 
㿘	疒 營 
㿙	疒 奰 
㿚	疒 羅 
㿛	疒 麗 
㿜	疒 自 龠 
㿞	白 毛 
㿢	明 白 
㿣	白 曷 
㿤	白 春 
㿥	白 隺 
㿦	殸 白 
㿧	白 壽 
㿨	白 歷 
㿩	白 黨 
㿪	皮 丸 
㿫	比 皮 
㿬	皮 巴 
㿮	央 皮 
㿯	合 皮 
㿰	交 皮 
㿱	折 皮 
㿳	皮 甾 
㿴	耷 皮 
㿵	皮 耎 
㿶	旁 皮 
㿷	差 皮 
㿸	皮 曼 
㿹	皮 達 
㿻	干 皿 
㿼	开 皿 
㿽	兮 皿 
㿾	宁 皿 
㿿	疋 皿 
䀀	氾 皿 
䀁	有 皿 
䀂	安 皿 
䀃	豕 皿 
䀄	宓 皿 
䀅	社 皿 
䀆	⺻ 火 皿 
䀇	古 缶 皿 
䀈	既 皿 
䀉	喬 皿 
䀊	漻 皿 
䀌	聿 百 百 皿 
䀍	贛 皿 
䀎	目 丂 
䀏	勹 目 
䀐	目 彡 
䀑	目 叉 
䀒	目 千 
䀓	目 丸 
䀔	目 刃 
䀕	目 引 
䀖	目 天 
䀗	目 夬 
䀘	目 开 
䀙	目 切 
䀚	目 卬 
䀛	目 勿 
䀜	勿 目 
䀞	目 斗 
䀟	目 弗 
䀠	目 目 
䀡	目 占 
䀢	目 矢 
䀣	目 必 
䀤	外 目 
䀥	目 乐 
䀦	目 古 
䀧	目 共 
䀨	目 舌 
䀩	目 各 
䀪	目 行 
䀫	目 合 
䀬	目 全 
䀭	目 亥 
䀮	目 巟 
䀯	目 甫 
䀰	目 谷 
䀱	目 夆 
䀲	目 每 
䀳	目 束 
䀴	目 巠 
䀵	目 矣 
䀶	目 良 
䀷	目 劫 
䀸	折 目 
䀺	攸 目 
䀻	目 甹 
䀼	目 辰 
䀽	目 延 
䀾	石 又 目 
䀿	目 折 
䁁	目 京 
䁂	臤 目 
䁃	目 表 
䁄	目 幸 
䁅	目 孟 
䁆	目 奄 
䁇	宓 目 
䁈	𢼄 目 
䁉	𫼉 目 
䁊	䀑 目 
䁋	目 枼 
䁌	目 胃 
䁍	目 咸 
䁎	目 亭 
䁏	目 要 
䁐	目 英 
䁑	目 昜 
䁒	目 咠 
䁔	目 爰 
䁕	目 昬 
䁗	目 豈 
䁘	目 䍃 
䁙	目 晏 
䁚	目 員 
䁛	目 鬼 
䁜	目 晃 
䁝	𤇾 目 
䁞	𠈌 丆 目 
䁟	目 差 
䁠	目 兼 
䁢	目 旋 
䁣	目 專 
䁤	目 啇 
䁥	目 匿 
䁦	目 虘 
䁧	目 𦰩 
䁨	目 郭 
䁩	目 魚 
䁫	目 黑 
䁬	目 曾 
䁭	目 猋 
䁮	目 朁 
䁯	目 翕 
䁰	目 項 
䁱	目 堯 
䁲	目 買 
䁳	目 莽 
䁴	目 亶 
䁵	目 睘 
䁶	目 敫 
䁷	𦥯 目 
䁸	目 農 
䁹	目 辟 
䁺	目 睪 
䁻	目 樂 
䁼	目 墨 
䁽	目 巤 
䁾	目 蔑 
䁿	默 目 
䂀	目 羲 
䂁	目 毚 
䂂	目 瞿 
䂃	目 爵 
䂄	目 矍 
䂅	目 蠻 
䂆	矛 勺 
䂇	矛 丑 
䂈	矛 虫 
䂉	矛 侯 
䂊	矛 象 
䂌	矛 童 
䂍	矛 暴 
䂎	矛 贊 
䂏	矢 召 
䂐	矢 出 
䂑	矢 此 
䂒	矢 吉 
䂔	矢 幸 
䂕	矢 彖 
䂖	石 丶 
䂗	石 匕 
䂙	石 ⻏ 
䂚	石 爻 
䂛	石 予 
䂜	石 丰 
䂝	石 戈 
䂞	石 木 
䂟	加 石 
䂠	石 矢 
䂡	石 丘 
䂢	石 冬 
䂣	石 此 
䂤	石 付 
䂥	石 民 
䂦	石 㐱 
䂧	石 尔 
䂩	石 因 
䂪	石 兆 
䂫	石 夅 
䂬	巩 石 
䂭	石 交 
䂯	石 庄 
䂰	石 利 
䂱	石 兑 
䂲	劫 石 
䂳	石 坐 
䂴	石 言 
䂵	石 工 页 
䂶	砝 刀 
䂷	石 乖 
䂸	石 或 
䂹	石 炙 
䂺	石 果 
䂻	石 長 
䂼	石 念 
䂽	石 卓 
䂾	石 來 
䃀	石 妻 
䃁	石 亞 
䃂	石 昆 
䃇	石 帛 
䃈	石 皆 
䃉	石 昬 
䃊	石 苴 
䃋	石 俞 
䃌	石 垔 
䃍	石 㒸 
䃏	石 星 
䃑	石 般 
䃒	石 鬲 
䃓	石 冓 
䃔	石 宫 
䃕	𤇾 石 
䃖	石 烏 
䃗	石 剥 
䃘	石 堅 
䃙	石 鹿 
䃚	石 族 
䃛	石 連 
䃜	殹 石 
䃝	石 教 
䃞	孰 石 
䃠	石 旋 
䃡	石 朁 
䃢	石 欽 
䃣	石 爲 
䃤	石 肅 
䃥	石 童 
䃦	敦 石 
䃧	隆 石 
䃩	石 農 
䃪	石 亶 
䃫	石 詹 
䃬	石 嵬 
䃭	石 感 
䃮	石 達 
䃯	石 楽 
䃰	石 察 
䃱	石 韯 
䃲	石 盤 
䃳	石 巤 
䃴	石 諸 
䃵	石 褭 
䃶	石 褱 
䃷	石 嬴 
䃸	石 韱 
䃹	石 闌 
䃺	石 靡 
䃻	石 霸 
䃽	礻 支 
䃾	礻 比 
䃿	礻 夫 
䄀	礻 戈 
䄁	礻 世 
䄂	礻 由 
䄃	礻 央 
䄄	礻 因 
䄅	龹 示 
䄆	礻 舌 
䄇	礻 呈 
䄈	礻 豆 
䄉	礻 我 
䄋	礻 奄 
䄌	礻 叕 
䄍	礻 昔 
䄎	礻 奇 
䄏	礻 芺 
䄐	祟 已 
䄑	礻 昏 
䄒	礻 念 
䄓	礻 皇 
䄔	礻 禹 
䄕	礻 畓 
䄘	礻 旁 
䄙	礻 冥 
䄚	礻 曹 
䄛	礻 婁 
䄜	礻 离 
䄝	礻 舂 
䄟	毳 示 
䄠	礻 亶 
䄡	礻 詹 
䄢	礻 齊 
䄤	礻 賴 
䄥	礻 靈 
䄹	禾 𠆢 千 
䄺	禾 夷 
䄻	禾 兆 
䄼	禾 㐁 
䄽	禾 西 
䄾	禾 戎 
䄿	禾 曳 
䅀	禾 列 
䅁	安 禾 
䅂	禾 各 
䅃	巩 禾 
䅄	禾 劦 
䅅	禾 圭 
䅆	禾 次 
䅇	覀 禾 
䅈	龹 禾 
䅊	禾 㡯 
䅋	禾 免 
䅌	禾 肙 
䅍	禾 廷 
䅎	禾 秀 
䅏	禾 尾 
䅐	禾 見 
䅑	禾 妥 
䅒	禾 芒 
䅓	禾 句 又 
䅔	禾 甾 
䅕	禾 居 
䅖	禾 奄 
䅗	禾 委 
䅘	禾 來 
䅙	禾 昆 
䅚	禾 卷 
䅛	禾 昌 
䅜	禾 垂 
䅝	禾 空 
䅞	禾 㝵 
䅠	禾 是 
䅡	禾 頁 
䅢	禾 胄 
䅣	禾 皇 
䅤	禾 臿 
䅥	禾 曷 
䅦	禾 苗 
䅧	禾 音 
䅩	禾 支 只 
䅪	禾 贵 
䅬	禾 益 
䅭	禾 旁 
䅮	禾 倉 
䅯	禾 唐 
䅰	禾 恩 
䅱	禾 豈 
䅲	禾 耆 
䅳	禾 芻 
䅴	禾 索 
䅵	禾 羔 
䅶	禾 辰 寸 
䅷	禾 荼 
䅸	禾 莘 
䅹	禾 婁 
䅺	禾 票 
䅻	禾 离 
䅼	禾 曼 
䅽	殸 禾 
䅾	禾 朁 
䅿	禾 華 
䆀	禾 黑 
䆁	禾 睪 
䆂	禾 廉 
䆃	道 禾 
䆄	禾 亶 
䆅	禾 資 
䆈	禾 遲 
䆉	禾 罷 
䆊	禾 冀 
䆍	禾 龍 
䆎	禾 韱 
䆏	禾 糞 
䆑	穴 丁 
䆒	穴 丸 
䆓	穴 允 
䆔	穴 中 
䆕	穴 夬 
䆖	穴 厷 
䆗	穴 叫 
䆘	穴 甲 
䆙	穴 正 
䆚	穴 同 
䆛	穴 吒 
䆜	穴 有 
䆝	穴 血 
䆞	穴 㫐 
䆟	穴 合 
䆠	穴 臣 
䆡	穴 良 
䆢	穴 抉 
䆣	穴 辰 
䆦	穴 炎 
䆨	穴 昊 
䆩	穴 𰥍 
䆪	光 空 
䆫	穴 怱 
䆬	穴 員 
䆭	穴 軒 
䆮	穴 浸 
䆯	穴 叕 女 
䆰	穴 區 
䆱	穴 淡 
䆲	穴 康 
䆳	穴 逐 
䆵	穴 曾 
䆶	穴 焦 
䆷	穴 矞 
䆸	穴 登 
䆹	穴 童 
䆺	穴 番 
䆻	穴 敢 
䆽	穴 豦 
䆾	穴 監 
䆿	穴 爿 臬 
䇀	穴 𩊐 
䇁	穴 鮮 
䇃	立 巳 
䇅	立 戈 
䇇	立 民 
䇈	立 圣 
䇋	立 多 
䇌	立 肖 
䇍	立 足 
䇎	立 昔 
䇏	立 享 
䇐	立 隶 
䇑	立 卑 
䇒	既 立 
䇓	須 立 
䇔	𣎆 立 
䇖	竹 𠚣 
䇗	竹 公 
䇘	竹 互 
䇙	竹 引 
䇛	竹 止 
䇜	竹 欠 
䇞	竹 甘 
䇟	竹 夕 力 
䇠	竹 主 
䇡	竹 宁 
䇢	竹 古 
䇣	竹 尒 
䇤	竹 丙 
䇥	竹 正 
䇧	竹 㐁 
䇨	竹 夅 
䇩	竹 曳 
䇪	竹 至 
䇫	竹 𦣞 
䇬	竹 朱 
䇭	竹 老 
䇮	竹 任 
䇯	竹 耳 
䇰	竹 丞 
䇵	竹 沂 
䇶	竹 角 
䇷	竹 别 
䇸	竹 呈 
䇹	竹 君 
䇺	竹 豆 
䇻	竹 尾 
䇼	竹 邑 
䇽	竹 折 
䇾	竹 言 
䈀	竹 删 
䈁	竹 侖 
䈂	竹 并 
䈃	竹 沼 
䈄	竹 函 
䈅	竹 或 
䈆	竹 戾 
䈇	竹 卓 
䈈	竹 肥 
䈉	竹 妾 
䈊	竹 夌 
䈋	竹 沓 
䈌	竹 沮 
䈍	竹 盲 
䈎	竹 枼 
䈏	竹 畐 
䈐	竹 恢 
䈑	竹 咼 
䈒	竹 南 
䈓	竹 曷 
䈕	竹 是 
䈖	竹 科 
䈗	竹 俊 
䈘	竹 兹 
䈙	竹 紂 
䈚	竹 怠 
䈛	竹 ⺊ 冊 又 
䈜	竹 侵 
䈝	竹 胥 
䈞	竹 亯 
䈟	竹 則 
䈠	竹 爰 
䈡	竹 怱 
䈢	竹 枲 
䈣	竹 政 
䈤	竹 柑 
䈥	竹 觔 
䈦	竹 㚇 
䈧	竹 為 
䈪	竹 鬲 
䈬	竹 浦 
䈭	竹 鬼 
䈮	竹 竘 
䈯	竹 真 
䈰	竹 捎 
䈱	竹 舀 
䈲	竹 般 
䈳	竹 𦐇 
䈴	竹 兼 
䈵	竹 翁 
䈶	竹 容 
䈷	竹 格 
䈸	竹 斛 
䈹	竹 宿 
䈺	竹 終 
䈻	竹 脯 
䈼	竹 密 
䈽	竹 堇 
䈾	竹 梢 
䈿	竹 冥 
䉀	竹 庶 
䉁	竹 聆 
䉂	竹 累 
䉃	竹 將 
䉄	竹 陵 
䉅	竹 執 
䉆	竹 鳥 
䉈	竹 散 
䉉	竹 觚 
䉊	竹 軬 
䉋	竹 媚 
䉌	竹 隊 
䉍	竹 悶 
䉎	竹 棠 
䉏	竹 解 
䉐	竹 軲 
䉑	竹 無 
䉒	竹 番 
䉓	竹 棵 
䉔	竹 殘 
䉕	竹 曾 
䉖	竹 軨 
䉗	竹 揖 
䉘	竹 棕 
䉙	竹 雲 
䉚	竹 ⺫ 𤬦 
䉛	竹 奧 
䉜	竹 雉 
䉝	竹 義 
䉞	竹 感 
䉟	竹 㨦 
䉠	竹 微 
䉡	竹 亶 
䉢	竹 嗇 
䉣	竹 舄 
䉥	竹 摠 
䉦	竹 遷 
䉧	竹 劉 
䉨	竹 毅 
䉪	竹 畾 
䉫	竹 黎 
䉬	竹 廢 
䉮	竹 閵 
䉯	竹 賢 
䉰	竹 骹 
䉱	竹 䙔 
䉲	竹 彌 
䉳	竹 鮮 
䉴	竹 襄 
䉵	𮅕 食 
䉶	竹 雙 
䉷	竹 嚴 
䉸	竹 辯 
䉹	竹 靈 
䉻	米 氏 
䉼	米 斤 
䉽	米 半 
䉾	北 米 
䉿	米 乎 
䊀	米 古 
䊂	米 朿 
䊃	米 𫥞 
䊄	巩 米 
䊅	米 名 
䊆	臼 米 
䊇	米 甫 
䊈	米 每 
䊉	米 宋 
䊊	米 尾 
䊍	𥝢 米 
䊎	米 卷 
䊐	米 昆 
䊑	米 尚 
䊓	米 是 
䊔	米 英 
䊖	米 南 
䊗	米 皇 
䊘	米 胄 
䊙	研 米 
䊚	米 追 
䊛	米 殺 
䊜	米 專 
䊝	米 悉 
䊞	米 啇 
䊟	米 㒼 
䊠	既 米 
䊡	米 曼 
䊣	米 黄 
䊤	米 覃 
䊥	米 肅 
䊦	米 壹 
䊧	米 費 
䊩	米 番 
䊪	米 萬 
䊫	米 罪 
䊬	稞 米 
䊭	米 壽 
䊮	米 翟 
䊯	米 廣 
䊰	米 諸 
䊱	米 韱 
䊲	粟 產 
䊳	米 靡 
䊴	米 簽 
䊵	糹 九 
䊶	糹 也 
䊺	糹 互 
䊻	糹 欠 
䊼	糹 止 
䊽	糹 夬 
䊾	糹 木 
䊿	糹 夫 
䋀	户 糸 
䋁	糹 亢 
䋂	糹 爻 
䋃	糹 毛 
䋄	糹 冈 
䋈	奴 糸 
䋉	糹 穴 
䋊	糹 正 
䋋	糹 民 
䋌	糹 巨 
䋎	糹 旦 
䋏	糹 乍 
䋐	糹 戉 
䋑	糹 丙 
䋓	糹 刍 
䋔	糹 丕 
䋕	任 糸 
䋖	糹 聿 
䋘	糹 耒 
䋙	糹 耳 
䋚	糹 羽 
䋛	糹 米 
䋜	户 又 糸 
䋞	糹 网 
䋟	糹 忌 
䋠	糹 甫 
䋢	折 糸 
䋣	每 糸 
䋤	素 勺 
䋥	糹 里 
䋦	糹 每 
䋧	糹 居 
䋨	糹 咅 
䋩	糹 兒 
䋪	糹 阿 
䋫	糹 争 
䋬	糹 忝 
䋭	糹 育 
䋮	糹 金 
䋯	𫼉 糸 
䋰	𰥍 糸 
䋱	糹 來 
䋲	糹 黾 
䋳	糹 背 
䋴	糹 柔 
䋵	糹 曷 
䋶	糹 頁 
䋷	敄 糸 
䋸	糹 盾 
䋹	糹 畐 
䋻	糹 南 
䋼	糹 盈 
䋽	糹 封 
䋾	糹 奓 
䋿	糹 畏 
䌀	糹 科 
䌁	糹 要 
䌂	糹 屋 
䌃	糹 削 
䌄	糹 㪅 
䌅	糹 唐 
䌆	糹 鬼 
䌇	糹 索 
䌊	糹 䍃 
䌋	糹 荅 
䌌	糹 習 
䌍	糹 堇 
䌎	略 糸 
䌏	糹 密 
䌐	糹 覓 
䌑	糹 堅 
䌒	糹 鹿 
䌓	每 殳 糸 
䌔	糹 區 
䌕	糹 麻 
䌖	糹 集 
䌗	糹 無 
䌘	敝 糸 
䌙	糹 黄 
䌚	糹 粟 
䌛	夕 言 系 
䌜	糹 業 
䌝	糹 禁 
䌞	糹 僉 
䌟	糹 辟 
䌠	㰹 糸 
䌡	糹 豊 
䌢	糹 零 
䌣	糹 管 
䌤	糹 爾 
䌥	糹 㥯 
䌦	糹 翟 
䌧	糹 壽 
䌨	糹 蔡 
䌩	糹 蔑 
䌪	糸 閻 
䌫	糸 覧 
䌬	糸 龍 
䌭	糸 蕉 
䌮	糸 霜 
䌯	糸 雚 
䌰	糸 聶 
䌱	糸 䇔 
䌳	糸 璽 
䌴	糸 羸 
䌵	糸 屬 
䌺	⺰ 耳 
䌻	⺰ 羽 
䌾	⺰ 南 
䌿	⺰ 畐 
䍂	缶 于 
䍃	爫 缶 
䍄	缶 占 
䍅	缶 令 
䍆	缶 宁 
䍈	缶 平 
䍉	缶 只 
䍊	缶 交 
䍋	缶 垂 
䍌	缶 咅 
䍍	𣪊 缶 
䍎	缶 薦 
䍐	⺲ 干 
䍑	网 干 
䍒	⺲ 木 
䍓	⺲ 牙 
䍔	⺲ 厷 
䍕	⺲ 氐 
䍖	⺲ 包 
䍗	⺲ 玄 
䍘	⺲ 米 
䍙	⺲ 每 
䍚	⺲ 良 
䍛	⺲ 固 
䍜	⺲ 隹 
䍝	⺲ 沓 
䍞	网 或 
䍟	⺲ 㚇 
䍠	⺲ 离 
䍡	⺲ 鹿 
䍢	⺲ 無 
䍣	⺲ 雷 
䍤	⺲ 齊 
䍥	⺲ 歷 
䍦	⺲ 離 
䍾	开 羽 
䍿	羽 王 
䎀	羽 戉 
䎁	古 羽 
䎂	羽 包 
䎄	召 羽 
䎅	白 羽 
䎆	羽 令 
䎇	舟 羽 
䎈	羽 曳 
䎉	羽 戍 
䎊	各 羽 
䎋	告 羽 
䎌	羽 足 
䎎	羽 耴 
䎏	含 羽 
䎐	𠦝 羽 
䎑	羽 录 
䎒	羽 戔 
䎓	羽 沓 
䎔	羽 尃 
䎕	𤇾 羽 
䎗	喬 羽 
䎘	肅 羽 
䎙	賓 羽 
䎚	羽 慧 
䎝	老 羽 
䎢	耒 乞 
䎣	耒 以 
䎤	耒 局 
䎦	耒 炎 
䎧	耒 咅 
䎨	耒 奄 
䎩	耒 甾 
䎪	耒 㝵 
䎫	耒 㚇 
䎬	耒 ⺫ 去 
䎭	耒 造 
䎮	耒 啇 
䎯	耒 𦰩 
䎰	耒 斮 
䎱	耒 罷 
䏎	⺼ 凡 
䏏	⺼ 于 
䏐	⺼ 夬 
䏑	𱼀 肉 
䏒	⺼ 片 
䏓	⺼ 元 
䏔	⺼ 丑 
䏕	⺼ 壬 
䏖	⺼ 引 
䏗	⺼ 气 
䏘	⺼ 匹 
䏙	⺼ 冘 
䏚	⺼ 少 
䏛	⺼ 勻 
䏜	⺼ 及 
䏞	⺼ 末 
䏟	⺼ 必 
䏠	⺼ 立 
䏢	⺼ 皮 
䏣	⺼ 且 
䏤	⺼ 司 
䏦	⺼ 舌 
䏧	⺼ 多 
䏨	⺼ 𠂤 
䏩	⺼ 合 
䏪	⺼ 耳 
䏫	⺼ 休 
䏬	⺼ 牟 
䏯	⺼ 志 
䏰	⺼ 忍 
䏱	⺼ 局 
䏳	⺼ 折 
䏴	⺼ 肖 
䏵	⺼ 尨 
䏶	⺼ 坒 
䏷	⺼ 旱 
䏸	⺼ 吾 
䏹	⺼ 見 
䏺	⺼ 夆 
䏻	䏍 去 
䏼	⺼ 戔 
䏽	⺼ 咅 
䏿	𢼄 ⺝ 
䐀	⺼ 奇 
䐁	⺼ 豖 
䐂	⺼ 录 
䐄	⺼ 臽 
䐅	⺼ 𡱁 
䐆	⺼ 采 
䐇	⺼ 曶 
䐈	⺼ 直 
䐉	⺼ 甾 
䐊	⺼ 昆 
䐋	⺼ 忩 
䐌	典 ⺝ 
䐎	⺼ 是 
䐏	⺼ 春 
䐐	⺼ 秋 
䐑	⺼ 枼 
䐒	⺼ 奓 
䐓	⺼ 頁 
䐔	⺼ 扁 
䐕	⺼ 咠 
䐖	⺼ 屎 
䐗	⺼ 者 
䐘	⺼ 爰 
䐚	⺼ 即 
䐛	⺼ 耷 
䐜	⺼ 真 
䐞	⺼ 弱 
䐟	⺼ 冓 
䐠	⺼ 荒 
䐢	⺼ 芻 
䐣	⺼ 員 
䐤	⺼ 差 
䐥	⺼ 翁 
䐦	⺼ 盍 
䐧	⺼ 高 
䐨	𣪊 ⺝ 
䐩	⺼ 豈 
䐪	⺼ 隽 
䐫	⺼ 從 
䐬	⺼ 曹 
䐭	⺼ 帶 
䐮	⺼ 產 
䐯	⺼ 累 
䐰	⺼ 脩 
䐱	⺼ 啇 
䐲	⺼ 習 
䐳	⺼ 魚 
䐴	既 ⺝ 
䐵	⺼ 黄 
䐶	⺼ 朁 
䐷	⺼ 單 
䐸	⺼ 畫 
䐹	⺼ 肅 
䐺	⺼ 覃 
䐻	⺼ 辜 
䐼	⺼ 絜 
䐽	⺼ 㒼 
䐾	⺼ 睪 
䐿	⺼ 奧 
䑀	⺼ 辟 
䑁	𦥯 ⺝ 
䑂	⺼ 與 
䑃	⺼ 蒙 
䑄	⺼ 鼻 
䑅	⺼ 夢 
䑆	⺼ 養 
䑇	⺼ 質 
䑈	⺼ 樂 
䑉	⺼ 嬴 
䑊	⺼ 遺 
䑋	⺼ 襄 
䑌	⺼ 闌 
䑍	⺼ 嬰 
䑎	⺼ 韱 
䑏	⺼ 雚 
䑐	臣 尓 
䑑	臣 菐 
䑔	臼 巿 
䑕	臼 ⺇ 𰀁 
䑗	臼 昜 
䑘	臼 差 
䑙	舌 冄 
䑚	舌 月 
䑛	舌 氐 
䑜	舌 枼 
䑝	吅 冖 舛 
䑞	匚 炎 舛 
䑟	舜 皇 
䑠	舟 了 
䑡	舟 叉 
䑣	舟 彡 
䑤	舟 今 
䑥	舟 及 
䑦	舟 句 
䑧	舟 付 
䑨	舟 㐌 
䑪	舟 合 
䑫	舟 并 
䑬	舟 兆 
䑭	舟 江 
䑯	舟 弟 
䑰	舟 步 
䑱	舟 宛 
䑲	舟 卓 
䑳	舟 侖 
䑴	舟 其 
䑵	舟 冐 
䑶	舟 青 
䑸	舟 宗 
䑹	舟 叜 
䑻	舟 斿 
䑼	舟 芻 
䑽	舟 𦐇 
䑿	舟 宿 
䒀	舟 符 
䒁	舟 習 
䒂	舟 將 
䒃	舟 造 
䒄	舟 冨 
䒅	舟 龹 目 
䒆	舟 𰕎 
䒇	舟 富 
䒈	舟 賁 
䒉	舟 舞 
䒊	兮 色 
䒋	央 色 
䒌	冥 色 
䒍	旁 色 
䒎	莽 色 
䒏	曾 色 
䒐	瞢 色 
䒑	丷 一 
䒒	艹 刁 
䒓	艹 丂 
䒔	艹 八 
䒕	艹 小 
䒖	艹 卂 
䒗	艹 乞 
䒚	艹 少 
䒛	艹 幻 
䒜	艹 牛 
䒝	艹 爻 
䒞	艹 冘 
䒟	艹 丹 
䒠	艹 丰 
䒡	艹 引 
䒢	艹 卬 
䒣	艹 冄 
䒤	艹 日 
䒥	艹 帀 
䒦	艹 乏 
䒧	艹 去 
䒨	艹 矢 
䒩	艹 禾 
䒪	艹 弁 
䒫	艹 代 
䒬	艹 示 
䒭	艹 ユ 寸 
䒰	艹 匡 
䒲	艹 奼 
䒳	艹 朵 
䒴	艹 有 
䒵	艹 好 
䒷	艹 舌 
䒸	艹 血 
䒹	艹 耒 
䒺	艹 糸 
䒻	艹 𡵆 
䒼	艹 曲 
䒽	艹 网 
䒾	艹 衣 
䒿	艹 冖 月 
䓂	艹 言 
䓃	艹 邑 
䓄	艹 㹞 
䓅	艹 沂 
䓆	艹 折 
䓇	艹 赤 
䓈	艹 役 
䓉	艹 邪 
䓊	艹 吾 
䓋	艹 汦 
䓌	艹 志 
䓍	艹 旱 
䓎	艹 灼 
䓏	艹 否 
䓐	艹 𡗥 
䓑	艹 汧 
䓒	艹 甸 
䓓	艹 寿 
䓗	艹 忩 
䓘	艹 咎 
䓙	艹 乖 
䓚	艹 徂 
䓜	艹 泜 
䓞	艹 戾 
䓟	艹 周 
䓠	艹 沓 
䓡	艹 知 
䓢	艹 固 
䓣	艹 兩 
䓤	艹 忽 
䓥	入 草 
䓦	艹 典 
䓧	艹 亟 
䓭	艹 刹 
䓮	艹 敄 
䓯	艹 毒 
䓰	艹 垔 
䓱	艹 柴 
䓲	艹 侻 
䓳	艹 很 
䓴	艹 耎 
䓵	艹 品 
䓶	艹 剌 
䓷	艹 洐 
䓸	艹 姧 
䓹	艹 食 
䓺	艹 美 
䓼	艹 娏 
䓽	艹 記 
䓾	艹 娑 
䓿	艹 圅 
䔁	艹 栗 
䔂	艹 宰 
䔃	艹 祖 
䔄	艹 䍃 
䔅	艹 哥 
䔆	艹 狸 
䔇	艹 豈 
䔈	艹 貢 
䔉	艹 秝 
䔊	艹 㻂 
䔋	艹 紗 
䔌	艹 皋 
䔎	艹 速 
䔏	艹 造 
䔐	艹 淺 
䔑	艹 斜 
䔒	艹 陪 
䔓	艹 許 
䔔	艹 竟 
䔕	艹 脯 
䔖	艹 陵 
䔗	艹 祥 
䔘	艹 缶 且 
䔙	艹 釣 
䔚	艹 脣 
䔛	艹 頃 
䔜	艹 聃 
䔝	艹 紫 
䔞	艹 率 
䔟	艹 移 
䔠	艹 梢 
䔡	艹 魚 
䔢	艹 𠈌 亏 
䔣	艹 犁 
䔤	艹 白 百 
䔧	艹 梨 
䔪	艹 𡙁 
䔫	艹 ⺪ 朿 
䔬	艹 異 
䔭	艹 甯 
䔮	艹 斯 
䔯	艹 酤 
䔰	艹 富 
䔱	艹 揖 
䔲	艹 登 
䔳	艹 然 
䔴	艹 𠭥 
䔶	艹 提 
䔷	艹 琴 
䔸	艹 猋 
䔹	艹 隊 
䔺	艹 隋 
䔻	艹 敦 
䔼	艹 刃 刃 𣥖 
䔽	艹 渴 
䔾	艹 揭 
䔿	艹 尊 
䕀	艹 款 
䕁	艹 棐 
䕃	艹 隂 
䕅	艹 嫂 
䕆	艹 榆 
䕇	艹 廆 
䕈	艹 牒 
䕉	艹 睪 
䕊	艹 亶 
䕋	艹 塘 
䕌	艹 稚 
䕍	艹 裔 
䕎	艹 日 畐 
䕏	艹 義 
䕑	艹 綏 
䕒	艹 嘉 
䕓	艹 察 
䕔	艹 銜 
䕕	艹 漫 
䕗	艹 鼻 
䕘	艹 領 
䕙	艹 截 
䕚	艹 匱 
䕛	艹 䛟 
䕝	艹 稱 
䕞	艹 閬 
䕟	艹 興 
䕠	艹 廢 
䕡	艹 閭 
䕢	艹 磋 
䕣	艹 褐 
䕤	艹 鄲 
䕦	艹 嬴 
䕧	艹 骹 
䕨	艹 縢 
䕩	艹 橑 
䕪	艹 澤 
䕫	艹 止 白 㔾 八 夂 
䕬	艹 彊 
䕭	艹 燅 
䕮	艹 幸 匊 
䕯	艹 瓢 
䕰	艹 燔 
䕱	艹 頭 
䕲	艹 廪 
䕳	艹 彌 
䕴	艹 穛 
䕵	艹 鴶 
䕶	艹 謢 
䕷	艹 縻 
䕸	艹 黠 
䕹	艹 雜 
䕺	艹 叢 
䕻	艹 麗 
䕼	艹 難 
䕽	艹 躅 
䕾	艹 嚴 
䕿	艹 𪄿 
䖁	萬 意 
䖂	艹 攣 
䖄	艹 㸐 
䖅	艹 靈 
䖆	艹 釀 
䖇	艹 鬱 
䖈	虍 匕 
䖊	㐅 虎 
䖋	虎 人 
䖌	虎 刂 
䖍	虍 攵 
䖎	⻖ 虎 
䖏	虍 匆 
䖐	斤 虎 
䖑	虎 日 
䖒	虍 豆 
䖓	出 虎 
䖔	去 虎 
䖕	虎 且 
䖖	虎 甲 
䖗	虍 咸 
䖘	虎 兔 
䖚	虎 烏 
䖛	虎 索 
䖜	虤 曰 
䖞	虫 寸 
䖟	亡 虫 
䖠	虫 凡 
䖡	虫 丑 
䖢	虫 少 
䖣	虫 爪 
䖤	夗 虫 
䖥	矛 虫 
䖦	虫 出 
䖧	虫 旦 
䖨	虫 石 
䖩	虫 必 
䖪	此 虫 
䖫	虫 八 干 
䖬	虫 甲 
䖭	龹 虫 
䖮	虫 向 
䖯	圭 虫 
䖰	虫 𠂢 
䖱	虫 匡 
䖲	虫 旬 
䖳	虫 宅 
䖴	虫 兆 
䖶	虫 豕 
䖷	虫 希 
䖸	我 虫 
䖹	虫 ⺸ 
䖺	攸 虫 
䖻	虫 㐬 
䖼	虫 却 
䖽	利 虫 
䖿	𥝢 虫 
䗀	虫 夌 
䗁	虫 奇 
䗂	虫 虎 
䗃	虫 戔 
䗄	虫 斧 
䗅	虫 長 
䗆	虫 官 
䗇	虫 匊 
䗈	虫 盲 
䗉	虫 昌 
䗊	虫 炎 
䗋	虫 某 
䗌	虫 星 
䗍	彖 虫 
䗎	虫 垔 
䗏	虫 叜 
䗐	施 虫 
䗑	虫 昱 
䗒	虫 並 
䗓	虫 怱 
䗔	虫 侯 
䗕	宛 虫 
䗗	虫 笄 
䗘	虫 盍 
䗙	宀 𠀎 八 虫 
䗚	虫 尃 
䗜	虫 留 
䗝	神 虫 
䗞	天 虫 虫 
䗟	殹 虫 
䗠	旋 虫 
䗡	虫 焉 
䗢	虫 造 
䗣	甘 虫 虫 
䗤	虫 庸 
䗥	虫 從 
䗧	虫 康 
䗨	虫 魚 
䗩	虫 戚 
䗫	虫 麻 
䗮	虫 爽 
䗯	虫 進 
䗰	虫 貫 
䗱	虫 菐 
䗲	虫 粦 
䗵	虫 畺 
䗶	虫 葛 
䗷	虫 意 
䗸	雍 虫 
䗹	虫 慈 
䗺	延 虫 虫 
䗻	虫 節 
䗼	虫 熏 
䗽	維 虫 
䗾	虫 㬎 
䗿	虫 寧 
䘀	阜 虫 虫 
䘁	截 虫 
䘃	虫 墨 
䘄	者 虫 虫 
䘅	能 虫 虫 
䘇	文 蟲 
䘈	虫 勵 
䘉	天 蟲 
䘊	虫 篾 
䘋	虫 韱 
䘌	匿 虫 虫 
䘍	萬 虫 虫 
䘎	虫 彎 
䘏	血 ⻏ 
䘐	血 刅 
䘑	血 永 
䘒	血 夋 
䘓	血 臽 
䘔	血 客 
䘕	行 亢 
䘘	行 素 
䘙	行 韋 帀 
䘚	衣 十 
䘝	衤 弋 
䘟	衤 弔 
䘠	衤 𠂇 乂 
䘡	比 衣 
䘢	衤 宁 
䘣	衤 此 
䘤	衤 术 
䘥	衤 甲 
䘦	衤 尼 
䘨	衤 交 
䘩	衤 旬 
䘪	衤 充 
䘫	如 衣 
䘬	衤 戎 
䘭	衤 至 
䘯	衤 肖 
䘰	衤 延 
䘱	衣 谷 
䘳	衤 金 
䘵	衤 彔 
䘶	衤 函 
䘷	衤 㡀 
䘸	衤 夜 
䘹	衤 卒 
䘺	衤 定 
䘻	衤 育 
䘼	衤 宛 
䘽	衤 兒 
䘾	衤 官 
䘿	衤 屈 
䙀	衤 朋 
䙁	衤 戔 
䙄	衤 臿 
䙅	衤 要 
䙆	衤 癸 
䙇	衤 耎 
䙈	衤 侯 
䙉	衤 盾 
䙊	衤 带 
䙌	衤 贵 
䙎	衤 奚 
䙏	衤 尃 
䙐	衤 鬲 
䙑	衤 衰 
䙒	衤 畜 
䙔	衤 區 
䙕	衤 從 
䙗	衤 啇 
䙘	衤 戚 
䙙	衤 犀 
䙚	鳥 衣 
䙛	衤 袞 
䙜	衤 逢 
䙝	衣 執 
䙞	衤 登 
䙟	衤 圍 
䙠	衤 厥 
䙡	衤 貴 
䙢	衤 曾 
䙣	衤 䨿 
䙤	衤 過 
䙥	衤 零 
䙦	衤 夢 
䙨	衤 𮖐 
䙩	衤 蒙 
䙪	樊 衣 
䙬	衤 嬰 
䙮	衤 雚 
䙯	衤 蹙 
䙰	衤 離 
䙱	衤 屬 
䙳	覀 火 
䙴	䙲 㔾 
䙵	覀 圭 
䙷	見 寸 
䙸	見 寸 
䙹	开 見 
䙺	火 見 
䙼	召 見 
䙽	𡗜 見 
䙾	它 見 
䙿	未 見 
䚂	赤 見 
䚃	卣 見 
䚄	录 見 
䚅	來 見 
䚆	英 見 
䚇	省 見 
䚈	垔 見 
䚉	契 見 
䚊	益 見 
䚋	員 見 
䚍	責 見 
䚎	舂 見 
䚏	粦 見 
䚐	智 見 
䚑	買 見 
䚒	童 見 
䚓	覃 見 
䚔	賓 見 
䚕	麗 見 
䚖	靈 見 
䚗	角 公 
䚘	行 角 
䚙	角 亘 
䚚	角 先 
䚛	角 告 
䚜	角 卑 
䚝	角 卒 
䚞	角 來 
䚟	角 㝵 
䚠	角 昆 
䚡	角 思 
䚢	角 枼 
䚣	角 是 
䚥	角 弱 
䚦	角 虒 
䚧	角 翏 
䚨	角 發 
䚩	角 喬 
䚪	角 睘 
䚫	敫 角 
䚬	角 粦 
䚭	角 雚 
䚮	言 乃 
䚯	言 刂 
䚰	言 匕 
䚱	言 小 
䚲	言 彡 
䚳	言 支 
䚴	言 月 
䚵	言 斗 
䚶	言 天 
䚷	言 兮 
䚸	言 介 
䚹	言 比 
䚺	言 攵 
䚼	言 丑 
䚽	言 毛 
䚾	言 壬 
䚿	言 欠 
䛀	言 反 
䛁	言 冄 
䛂	言 升 
䛃	言 元 
䛄	言 夗 
䛅	言 甲 
䛆	言 由 
䛇	言 㕣 
䛈	言 矢 
䛉	言 民 
䛊	言 只 
䛋	言 戊 
䛌	言 包 
䛍	言 弗 
䛎	言 穴 
䛏	言 尼 
䛐	司 言 
䛑	言 必 
䛒	巧 言 
䛔	言 而 
䛖	言 曳 
䛗	臣 言 
䛘	言 任 
䛙	言 休 
䛚	㓞 言 
䛛	言 回 
䛜	言 囟 
䛝	言 丑 山 
䛞	言 旱 
䛟	言 夾 
䛠	言 豆 
䛡	言 𠯑 
䛢	言 秃 
䛣	言 甹 
䛤	言 足 
䛥	言 希 
䛦	言 谷 
䛧	言 𠃊 米 
䛨	言 辛 
䛩	言 亞 
䛪	言 穹 
䛫	言 長 
䛬	言 匋 
䛭	言 幸 
䛮	言 咎 
䛯	言 居 
䛰	言 昆 
䛱	言 忠 
䛲	言 帛 
䛳	言 奄 
䛴	言 奇 
䛵	言 受 
䛶	言 丰 木 
䛷	言 宛 
䛸	言 店 
䛹	言 彖 
䛺	言 界 
䛻	言 盾 
䛽	言 臿 
䛾	言 素 
䜀	言 刃 刃 止 
䜁	言 奊 
䜃	誰 土 
䜄	言 犀 
䜅	言 崔 
䜆	麻 言 
䜇	言 衮 
䜈	言 巢 
䜉	言 桼 
䜊	言 曹 
䜋	言 貴 
䜌	糸 言 糸 
䜍	言 尞 
䜎	言 勞 
䜏	言 隋 
䜐	隋 言 
䜑	言 惡 
䜒	言 奧 
䜓	言 葉 
䜔	言 遀 
䜕	言 萬 
䜖	言 賈 
䜗	言 感 
䜘	言 敬 
䜙	言 㬎 
䜚	言 遝 
䜛	言 𭀰 
䜜	言 睿 
䜝	言 㡭 
䜞	言 齊 
䜟	言 韯 
䜠	言 質 
䜡	言 憂 
䜢	言 憲 
䜪	谷 九 
䜫	谷 工 
䜬	谷 由 
䜮	谷 牢 
䜯	谷 匊 
䜰	谷 皋 
䜱	谷 曼 
䜲	谷 巤 
䜴	豆 攴 
䜵	豆 皮 
䜶	豆 夅 
䜷	豆 𠬶 
䜸	豆 尾 
䜹	豆 束 
䜺	豆 昔 
䜻	豆 是 
䜼	敄 豆 
䜽	豆 俞 
䜾	豆 音 
䝀	豆 留 
䝁	𤇾 豆 
䝂	臣 殳 豆 
䝃	豆 㬎 
䝄	豆 雙 
䝅	豕 土 
䝈	豕 厄 
䝊	豕 疌 
䝋	豕 宗 
䝌	豕 叕 
䝍	豕 軍 
䝎	豕 耑 
䝏	豕 婁 
䝐	豕 隋 
䝑	豕 童 
䝒	豕 聚 
䝓	豕 巤 
䝕	豕 聶 
䝖	豸 爪 
䝘	豸 殳 
䝚	豸 尼 
䝛	豸 皮 
䝜	豸 夋 
䝝	豸 奇 
䝞	豸 虎 
䝟	豸 契 
䝠	豸 原 
䝡	豸 㒼 
䝢	豸 曼 
䝣	豸 渠 
䝤	豸 尞 
䝥	豸 皐 
䝦	豸 衆 
䝧	貝 匀 
䝩	貝 㐱 
䝪	貝 疋 
䝫	貝 乍 
䝬	貝 主 
䝭	貝 句 
䝮	貝 玄 
䝯	貝 㐌 
䝰	貝 寺 
䝱	劦 貝 
䝲	貝 尽 
䝳	𣦼 貝 
䝵	貝 甫 
䝶	貝 京 
䝷	知 貝 
䝸	貝 芰 
䝹	貝 宛 
䝺	文 文 貝 
䝻	貝 居 
䝼	貝 青 
䝽	貝 厓 
䝾	武 貝 
䝿	臾 貝 
䞀	貝 侯 
䞁	貝 匽 
䞂	貝 耎 
䞃	貝 致 
䞄	施 貝 
䞅	貝 唇 
䞇	埶 貝 
䞈	貝 爲 
䞉	貝 龹 貝 
䞊	貝 虍 八 𠆢 目 
䞋	貝 親 
䞌	贝 舌 
䞍	贝 青 
䞑	赤 工 
䞒	赤 同 
䞓	赤 巠 
䞔	赤 尾 
䞕	赤 需 
䞖	走 弋 
䞗	走 才 
䞙	走 帀 
䞚	走 支 
䞛	走 丏 
䞜	走 不 
䞝	走 玉 
䞞	走 弗 
䞟	走 白 
䞠	走 石 
䞡	走 旦 
䞢	走 乍 
䞣	走 斥 
䞤	走 句 
䞥	走 有 
䞦	走 各 
䞧	走 后 
䞨	走 圭 
䞩	走 合 
䞪	走 匠 
䞫	走 君 
䞬	走 秀 
䞭	走 夋 
䞮	走 余 
䞯	走 孚 
䞰	走 赤 
䞱	走 谷 
䞳	走 咅 
䞴	走 周 
䞵	走 叕 
䞶	走 易 
䞷	走 屈 
䞸	走 示 口 
䞹	走 皇 
䞺	走 盾 
䞻	走 勇 
䞼	走 彖 
䞽	走 索 
䞾	走 虒 
䞿	宀 𠀎 八 走 
䟀	走 差 
䟁	走 巢 
䟂	走 曼 
䟃	走 參 
䟄	走 責 
䟅	斬 走 
䟆	走 畢 
䟇	走 幾 
䟈	走 𢦏 呈 
䟉	走 蜀 
䟊	走 豦 
䟋	走 詹 
䟌	走 截 
䟍	走 臱 
䟏	走 樂 
䟐	走 歷 
䟑	走 龠 
䟒	走 雚 
䟓	𧾷 丁 
䟔	𧾷 卜 
䟕	𧾷 叉 
䟖	𧾷 山 
䟗	𧾷 氏 
䟘	𧾷 亢 
䟙	𧾷 切 
䟚	𧾷 亓 
䟛	𧾷 巿 
䟝	𧾷 殳 
䟞	𧾷 少 
䟟	斥 足 
䟠	𧾷 戉 
䟡	𧾷 氐 
䟢	𧾷 尓 
䟣	𧾷 术 
䟤	𧾷 必 
䟥	𧾷 矛 
䟦	𧾷 叐 
䟧	𧾷 田 
䟨	𧾷 民 
䟩	𧾷 去 
䟪	𧾷 乏 
䟫	龸 足 
䟬	𧾷 丘 
䟭	𧾷 乍 
䟮	𧾷 伏 
䟯	𧾷 舌 
䟰	𧾷 行 
䟲	𧾷 充 
䟵	𧾷 求 
䟶	𧾷 坐 
䟷	𧾷 折 
䟹	𧾷 寽 
䟺	𧾷 貝 
䟻	𧾷 余 
䟼	𧾷 武 
䟽	𧾷 㐬 
䟾	𧾷 叕 
䟿	𧾷 录 
䠀	𧾷 尚 
䠂	林 足 
䠃	𧾷 兩 
䠄	𧾷 典 
䠅	𧾷 囷 
䠆	𧾷 長 
䠇	𧾷 屈 
䠈	𧾷 隶 
䠉	𧾷 官 
䠊	𧾷 非 
䠍	𧾷 叚 
䠎	𧾷 屋 
䠏	𧾷 癸 
䠐	𧾷 狊 
䠑	𧾷 奎 
䠒	𧾷 胡 
䠓	𧾷 酋 
䠔	𧾷 㒸 
䠕	𧾷 柴 
䠗	𧾷 臭 
䠘	𧾷 𣬉 
䠙	𧾷 旁 
䠚	𧾷 窊 
䠛	𧾷 䍃 
䠜	𧾷 茸 
䠝	𧾷 員 
䠞	𧾷 戚 
䠟	執 足 
䠠	帶 足 
䠡	𧾷 虘 
䠣	𧾷 巽 
䠤	𧾷 單 
䠥	𧾷 敝 
䠦	𧾷 智 
䠧	𧾷 屠 
䠨	𧾷 詹 
䠩	𧾷 歲 
䠪	𧾷 㡭 
䠫	𧾷 聚 
䠬	𧾷 鄧 
䠭	𧾷 賴 
䠮	𧾷 駦 
䠯	𧾷 龠 
䠰	𧾷 雚 
䠱	𧾷 屬 
䠲	身 令 
䠳	身 出 
䠴	身 立 
䠵	身 付 
䠶	身 矢 
䠷	身 兆 
䠸	身 夸 
䠹	身 亥 
䠻	身 穹 
䠼	身 俞 
䠽	身 豈 
䠾	身 閃 
䠿	身 貴 
䡀	身 亶 
䡁	身 龍 
䡂	車 丩 
䡃	車 力 
䡅	車 川 
䡆	車 公 
䡇	車 元 
䡈	車 爻 
䡉	車 亢 
䡊	車 反 
䡋	車 支 
䡌	車 厷 
䡍	車 夫 
䡎	車 户 
䡏	車 弘 
䡐	車 它 
䡑	車 民 
䡒	車 田 
䡓	行 車 
䡔	車 多 
䡕	車 丞 
䡗	巩 車 
䡘	車 甸 
䡙	車 良 
䡚	車 皃 
䡜	車 坴 
䡝	車 宛 
䡞	目 大 車 
䡟	車 卑 
䡡	車 皆 
䡢	車 扁 
䡣	車 軍 
䡤	者 車 
䡥	車 容 
䡦	車 桑 
䡧	車 烏 
䡨	差 車 
䡩	車 真 
䡪	車 扇 
䡫	車 逢 
䡬	車 曼 
䡭	車 羞 
䡯	車 悤 
䡰	殸 車 
䡱	車 區 
䡲	車 單 
䡳	車 斯 
䡴	車 童 
䡵	車 遂 
䡶	車 辟 
䡷	車 蓋 
䡹	車 疐 
䡺	車 慧 
䡻	車 臱 
䡼	車 霝 
䡽	車 贊 
䡾	車 獻 
䡿	車 靈 
䢀	车 乞 
䢁	车 月 
䢃	辟 乂 
䢄	枲 𣓀 
䢅	臼 辰 
䢇	穴 辰 寸 
䢈	辰 會 
䢊	辶 子 
䢋	辶 丌 
䢌	辶 巿 
䢍	辶 方 
䢐	辶 且 
䢑	辶 氐 
䢒	辶 交 
䢓	辶 宇 
䢔	辶 合 
䢕	辶 戌 
䢖	辶 聿 
䢗	辶 曲 
䢙	辶 貝 
䢚	辶 更 
䢛	辶 冏 
䢝	辶 亞 
䢞	辶 林 
䢟	辶 放 
䢠	辶 灷 
䢡	辶 枼 
䢢	辶 倉 
䢣	辶 夕 言 
䢤	辶 禾 术 
䢥	辶 正 目 
䢦	辶 率 
䢧	辶 翏 
䢨	辶 從 
䢩	辶 敔 
䢪	辶 喬 
䢫	辶 隋 
䢭	辶 羡 
䢮	辶 雷 
䢯	辶 㷠 
䢰	辶 翟 
䢱	辶 賣 
䢲	辶 矍 
䢳	几 ⻏ 
䢵	云 ⻏ 
䢸	且 ⻏ 
䢹	巨 ⻏ 
䢻	臣 ⻏ 
䢽	共 邑 
䢾	先 ⻏ 
䢿	安 ⻏ 
䣀	危 ⻏ 
䣁	羽 ⻏ 
䣂	耒 ⻏ 
䣄	余 ⻏ 
䣅	辰 ⻏ 
䣆	巠 ⻏ 
䣇	求 ⻏ 
䣊	尚 ⻏ 
䣋	采 ⻏ 
䣌	底 ⻏ 
䣍	奄 ⻏ 
䣎	甾 ⻏ 
䣐	英 ⻏ 
䣑	厘 ⻏ 
䣓	鬲 ⻏ 
䣕	馬 ⻏ 
䣖	馬 邑 
䣙	崩 ⻏ 
䣚	婁 ⻏ 
䣛	桼 ⻏ 
䣜	虘 ⻏ 
䣝	屠 ⻏ 
䣞	㖾 ⻏ 
䣟	朁 ⻏ 
䣠	替 ⻏ 
䣡	義 ⻏ 
䣢	耤 ⻏ 
䣣	黨 ⻏ 
䣤	矍 ⻏ 
䣥	酉 匕 
䣦	酉 力 
䣧	酉 弋 
䣩	酉 屯 
䣪	酉 巿 
䣫	酉 支 
䣬	酉 戈 
䣭	酉 犬 
䣮	酉 犮 
䣯	酉 且 
䣰	酉 巨 
䣱	酉 句 
䣲	酉 弁 
䣴	酉 兇 
䣵	酉 耳 
䣶	酉 舌 
䣷	酉 朱 
䣸	任 酉 
䣹	酉 伐 
䣺	酉 肙 
䣻	酉 含 
䣼	酉 京 
䣽	知 酉 
䣾	酉 宜 
䣿	酉 盂 
䤁	酉 甚 
䤂	酉 某 
䤃	酉 音 
䤄	酉 面 
䤅	酉 俞 
䤆	酉 癸 
䤉	酉 𥁑 
䤊	酉 茸 
䤋	酋 或 
䤌	酉 倉 
䤍	酉 㒼 
䤎	酉 矞 
䤏	酉 非 手 
䤐	酉 朁 
䤑	酉 黄 
䤒	酉 幾 
䤓	酉 蒙 
䤔	漸 酉 
䤕	酉 樂 
䤖	酉 暴 
䤗	𥪴 酉 
䤘	酉 韱 
䤙	酉 蠡 
䤛	金 丩 
䤝	金 卬 
䤞	金 尤 
䤟	金 冗 
䤠	金 止 
䤡	金 冉 
䤣	金 乎 
䤤	金 亥 
䤥	金 危 
䤦	金 伐 
䤧	金 回 
䤨	金 𠂢 
䤩	金 宅 
䤪	金 朵 
䤫	金 岑 
䤬	金 沙 
䤭	金 希 
䤮	金 步 
䤯	金 形 
䤰	坎 金 
䤱	金 𡵱 
䤲	金 赤 
䤳	金 夜 
䤴	金 函 
䤵	金 非 
䤶	金 奄 
䤷	金 匽 
䤸	金 彖 
䤹	金 叜 
䤺	金 斫 
䤼	金 泉 
䤽	金 眔 
䤾	金 舀 
䤿	金 挈 
䥀	金 蚩 
䥁	金 圅 
䥂	金 冡 
䥃	金 隺 
䥄	金 厝 
䥅	十 𤣩 王 金 
䥆	亠 非 金 
䥇	金 扇 
䥈	金 莽 
䥉	金 寃 
䥋	金 烹 
䥌	宀 日 日 金 
䥍	執 金 
䥎	金 脣 
䥏	金 御 
䥐	務 金 
䥑	金 麥 
䥒	強 金 
䥓	金 基 
䥔	金 粟 
䥕	金 敝 
䥖	金 奠 
䥗	金 款 
䥘	金 㫺 
䥙	金 隊 
䥛	金 絜 
䥜	金 閑 
䥝	金 麀 
䥞	金 敫 
䥟	金 揭 
䥡	金 牒 
䥢	鼓 金 
䥣	毀 金 
䥤	金 雹 
䥥	金 亷 
䥨	金 閭 
䥩	金 微 
䥪	金 㬎 
䥫	金 截 
䥬	金 蒪 
䥭	求 求 金 
䥮	金 覀 臣 卩 
䥯	金 罷 
䥰	金 蝱 
䥱	金 寫 
䥲	金 歐 
䥳	金 憂 
䥴	金 嶲 
䥵	金 曉 
䥶	金 歷 
䥷	金 㔍 
䥸	彌 金 
䥾	钅 写 
䦂	钅 扇 
䦆	钅 矍 
䦇	镸 八 ㇉ 
䦈	镸 左 
䦊	镸 尗 
䦋	镸 敖 
䦌	門 土 
䦍	門 乞 
䦎	門 元 
䦏	門 介 
䦐	門 手 
䦑	門 夬 
䦒	門 石 
䦓	門 占 
䦔	門 旦 
䦕	門 并 
䦖	門 吉 
䦗	門 血 
䦘	門 艮 
䦙	門 寺 
䦚	門 舌 
䦛	門 争 
䦜	門 吾 
䦝	門 赤 
䦞	門 汪 
䦟	門 坐 
䦠	門 豖 
䦡	門 官 
䦢	門 法 
䦣	門 咅 
䦤	門 叕 
䦥	門 林 
䦦	門 金 
䦧	門 兒 
䦨	門 東 
䦩	門 𡕥 
䦪	門 曷 
䦫	門 英 
䦬	門 契 
䦭	門 香 
䦮	門 春 
䦯	門 致 
䦱	門 爲 
䦲	門 詹 
䦳	門 鄉 
䦴	門 睪 
䦵	門 爾 
䦶	门 争 
䦷	门 坐 
䦹	⻖ 十 
䦺	⻖ 丁 
䦻	⻖ 子 
䦼	⻖ 夬 
䦽	⻖ 予 
䦾	𠂤 允 
䧁	⻖ 句 
䧂	⻖ 召 
䧃	⻖ 田 
䧄	⻖ 各 
䧅	⻖ 夷 
䧆	⻖ 共 
䧇	⻖ 衣 
䧉	⻖ 里 
䧊	⻖ 告 
䧋	⻖ 見 
䧌	⻖ 妥 
䧍	⻖ 谷 
䧎	⻖ 肙 
䧑	⻖ 定 
䧒	⻖ 來 
䧓	⻖ 周 
䧔	⻖ 念 
䧕	⻖ 或 
䧖	⻖ 戔 
䧗	⻖ 复 
䧘	⻖ 彖 
䧙	⻖ 山 𠇍 
䧚	⻖ 高 
䧛	⻖ 旁 
䧜	⻖ 唐 
䧝	⻖ 蚩 
䧞	⻖ 馬 
䧟	⻖ 舀 
䧠	⻖ 專 
䧡	⻖ 庸 
䧢	⻖ 區 
䧤	⻖ 菐 
䧥	⻖ 惠 
䧦	⻖ 爲 
䧧	⻖ 義 
䧨	⻖ 業 
䧪	⻖ 广 夾 女 
䧫	⻖ 豪 
䧬	⻖ 賓 
䧮	⻖ 憲 
䧯	⻖ 毚 
䧰	⻖ 鯀 
䧲	干 隹 
䧳	止 隹 
䧴	支 隹 
䧵	冘 隹 
䧶	隹 六 
䧷	冬 隹 
䧹	广 倠 
䧺	右 隹 
䧼	告 隹 
䧽	釆 隹 
䧿	昔 隹 
䨀	籴 隹 
䨁	敄 隹 
䨂	秋 隹 
䨄	酓 隹 
䨅	尞 隹 
䨆	敝 隹 
䨈	賓 隹 
䨋	雨 乇 
䨌	雨 元 
䨍	雨 井 
䨎	雨 弘 
䨏	雨 次 
䨐	雨 合 
䨑	雨 夷 
䨒	雨 羽 
䨓	雨 回 
䨔	雨 光 
䨖	雨 有 
䨗	雨 孚 
䨘	雨 見 
䨙	雨 氵 壬 
䨚	雨 忽 
䨛	雨 析 
䨜	雨 朋 
䨝	雨 青 
䨞	雨 禹 
䨟	雨 洼 
䨠	雨 曷 
䨡	雨 函 
䨢	雨 甚 
䨤	雨 迪 
䨥	雨 隻 
䨦	雨 旁 
䨨	雨 追 
䨪	雨 埋 
䨫	雨 麥 
䨬	雨 淋 
䨭	雲 肖 
䨮	雨 彗 
䨯	雨 陳 
䨰	雨 㴖 
䨱	雨 復 
䨲	需 兔 
䨳	雨 覞 
䨴	雨 對 
䨵	雨 潭 
䨶	雨 厶 鼎 
䨷	雨 𢿨 
䨸	雨 隱 
䨹	雨 儵 
䨼	青 蒦 
䨽	非 己 
䨾	广 非 
䨿	天 非 
䩀	非 貝 
䩁	非 毳 
䩂	面 今 
䩃	面 比 
䩅	面 皮 
䩆	面 乍 
䩇	面 占 
䩈	面 每 
䩉	面 甫 
䩊	面 宛 
䩋	面 麻 
䩌	面 焦 
䩍	面 尞 
䩏	面 蔑 
䩐	革 乞 
䩑	革 弓 
䩒	革 于 
䩓	革 勾 
䩔	革 殳 
䩕	革 卬 
䩗	革 月 
䩘	革 𢆰 
䩙	革 玄 
䩚	革 氐 
䩛	革 必 
䩜	革 由 
䩝	革 瓜 
䩞	革 占 
䩟	革 夷 
䩡	革 夾 
䩢	革 折 
䩣	革 余 
䩤	革 見 
䩥	革 延 
䩦	攸 革 
䩧	革 言 
䩨	革 長 
䩩	革 宛 
䩪	革 官 
䩫	革 兩 
䩬	革 奉 
䩮	革 录 
䩯	革 亟 
䩰	革 咠 
䩱	革 俞 
䩲	革 度 
䩳	革 叜 
䩴	革 胡 
䩵	革 軍 
䩶	革 蚩 
䩷	革 旁 
䩸	革 茸 
䩹	革 鬲 
䩺	革 翁 
䩻	革 馬 
䩼	革 逢 
䩽	革 區 
䩾	革 庶 
䩿	革 賁 
䪀	革 悹 
䪁	革 菐 
䪃	革 敦 
䪄	革 黄 
䪅	革 蜀 
䪆	革 豊 
䪇	革 蒪 
䪈	革 遣 
䪉	革 巤 
䪊	革 龍 
䪋	革 遺 
䪌	革 毚 
䪍	革 闌 
䪎	革 巂 
䪏	韋 内 
䪐	韋 必 
䪑	韋 它 
䪒	韋 主 
䪓	韋 占 
䪔	韋 甫 
䪕	韋 匊 
䪖	韋 复 
䪗	韋 叚 
䪘	韋 是 
䪙	韋 尃 
䪚	韋 𦐇 
䪛	韋 番 
䪜	韋 詹 
䪝	韋 蒦 
䪞	天 韭 
䪢	𠂔 次 韭 
䪤	韭 番 
䪥	㕢 韭 
䪦	音 工 
䪧	音 也 
䪨	音 勺 
䪩	音 今 
䪫	音 巠 
䪬	音 孛 
䪮	音 芻 
䪯	𤇾 音 
䪰	音 意 
䪱	己 頁 
䪲	丌 頁 
䪳	尹 頁 
䪴	冘 頁 
䪵	牙 頁 
䪶	且 頁 
䪷	句 頁 
䪸	民 頁 
䪹	丕 頁 
䪺	去 頁 
䪻	弁 頁 
䪼	出 頁 
䪽	号 頁 
䪾	頁 㐱 
䪿	囟 頁 
䫀	艮 頁 
䫁	自 頁 
䫂	多 頁 
䫃	辰 頁 
䫄	兑 頁 
䫅	宋 頁 
䫆	成 頁 
䫇	須 冄 
䫈	岑 頁 
䫉	豸 頁 
䫊	否 頁 
䫋	委 頁 
䫌	卑 頁 
䫍	非 頁 
䫎	叕 頁 
䫏	其 頁 
䫐	林 頁 
䫑	奇 頁 
䫒	昏 頁 
䫓	咅 頁 
䫔	契 頁 
䫕	帝 頁 
䫖	甚 頁 
䫗	叚 頁 
䫘	曷 頁 
䫙	桒 頁 
䫚	咼 頁 
䫛	侯 頁 
䫜	幽 頁 
䫝	香 頁 
䫞	羔 頁 
䫟	員 頁 
䫠	須 否 
䫡	兼 頁 
䫢	虒 頁 
䫣	奚 頁 
䫤	冥 頁 
䫥	鬼 頁 
䫦	盍 頁 
䫨	敖 頁 
䫩	參 頁 
䫪	爽 頁 
䫫	婁 頁 
䫬	朁 頁 
䫭	貴 頁 
䫮	尋 頁 
䫰	頁 粦 
䫱	𦓔 頁 
䫲	感 頁 
䫳	蜀 頁 
䫴	禁 頁 
䫵	臱 頁 
䫶	樊 頁 
䫷	噩 頁 
䫸	風 刀 
䫹	風 工 
䫺	厷 風 
䫻	風 日 
䫼	風 夬 
䫽	風 毛 
䫾	風 必 
䫿	風 召 
䬀	風 幼 
䬁	風 它 
䬂	風 戉 
䬃	風 立 
䬄	風 戌 
䬅	風 劦 
䬆	風 利 
䬇	兑 風 
䬈	風 兑 
䬉	風 赤 
䬊	風 夾 
䬋	風 夌 
䬌	虎 風 
䬍	風 忽 
䬎	風 或 
䬏	風 咅 
䬐	風 委 
䬑	風 胃 
䬒	風 叜 
䬓	風 音 
䬔	風 俞 
䬖	風 皇 
䬗	昜 風 
䬘	風 高 
䬙	風 䍃 
䬛	風 畢 
䬜	風 离 
䬝	風 黄 
䬞	風 壽 
䬟	風 劉 
䬠	雨 飛 
䬡	者 飛 
䬢	飠 刀 
䬣	飠 乞 
䬤	尸 食 
䬥	弋 食 
䬦	飠 殳 
䬧	飠 元 
䬨	飠 勼 
䬪	飠 不 
䬫	飠 氐 
䬬	飠 央 
䬮	飠 以 
䬯	飠 占 
䬰	飠 召 
䬱	飠 本 
䬲	飠 句 
䬳	飠 半 
䬴	飠 末 
䬵	飠 亥 
䬶	飠 艮 
䬷	飠 多 
䬹	飠 至 
䬺	飠 羊 
䬻	飠 戋 
䬼	飠 肙 
䬽	飠 兑 
䬾	飠 弟 
䬿	飠 尾 
䭀	飠 迅 
䭁	折 食 
䭂	飠 邑 
䭃	飠 念 
䭄	飠 事 
䭅	飠 固 
䭆	卧 食 
䭇	飠 勹 吉 
䭈	飠 建 
䭊	飠 英 
䭋	飠 保 
䭌	胡 食 
䭍	飠 龶 皿 
䭎	飠 枼 
䭐	飠 恙 
䭑	飠 兼 
䭒	飠 息 
䭓	飠 豈 
䭕	斬 食 
䭖	飠 庶 
䭗	飠 竟 
䭘	飠 景 
䭙	飠 朁 
䭚	飠 童 
䭛	飠 敢 
䭝	飠 會 
䭞	飠 睪 
䭟	飠 葉 
䭠	飠 廉 
䭡	飠 爫 工 彐 心 
䭢	飠 寧 
䭣	飠 齊 
䭤	飠 遣 
䭥	飠 養 
䭦	飠 薄 
䭧	飠 縻 
䭨	飠 巂 
䭩	飠 靡 
䭪	饣 量 
䭫	旨 首 
䭬	旨 𩠐 
䭭	首 頁 
䭯	香 出 
䭱	香 㡀 
䭲	香 奇 
䭳	魏 香 
䭴	馬 十 
䭵	馬 凡 
䭶	馬 丌 
䭷	馬 毛 
䭸	馬 父 
䭹	馬 卬 
䭺	馬 亢 
䭻	馬 分 
䭼	馬 亓 
䭽	馬 牛 
䭾	馬 犬 
䭿	馬 失 
䮀	馬 包 
䮁	馬 弁 
䮂	馬 犮 
䮄	馬 玄 
䮇	馬 聿 
䮈	馬 多 
䮊	馬 夷 
䮋	馬 列 
䮍	馬 衣 
䮎	馬 希 
䮏	馬 吾 
䮑	馬 寽 
䮒	馬 甫 
䮓	馬 卓 
䮔	馬 垂 
䮕	馬 叕 
䮖	馬 昌 
䮗	馬 岸 
䮘	馬 兒 
䮙	馬 或 
䮚	馬 夌 
䮛	馬 附 
䮜	馬 枼 
䮝	馬 軍 
䮞	馬 春 
䮟	馬 叜 
䮠	馬 畐 
䮡	馬 复 
䮢	馬 臿 
䮤	馬 隺 
䮥	馬 鬲 
䮧	𠦝 𠆢 馬 
䮨	馬 宰 
䮩	馬 骨 
䮪	馬 桀 
䮫	馬 婁 
䮬	馬 莫 
䮭	馬 覓 
䮮	馬 麥 
䮯	馬 敖 
䮰	馬 啇 
䮱	馬 逐 
䮲	馬 黄 
䮳	馬 番 
䮴	馬 登 
䮵	馬 童 
䮷	馬 蜀 
䮸	𦥯 馬 
䮹	馬 歲 
䮺	馬 齊 
䮻	馬 壽 
䮼	馬 㷠 
䮽	馬 麃 
䮾	馬 龍 
䮿	馬 蹇 
䯀	馬 聶 
䯁	馬 羸 
䯂	驫 木 
䯅	⻢ 聂 
䯆	骨 乚 
䯇	骨 力 
䯈	骨 元 
䯉	骨 欠 
䯊	骨 可 
䯋	骨 犮 
䯌	骨 尻 
䯍	骨 令 
䯎	骨 𫢉 
䯏	骨 舌 
䯐	骨 肉 
䯑	骨 光 
䯒	骨 行 
䯓	骨 圭 
䯔	骨 宅 
䯕	骨 廷 
䯖	骨 良 
䯗	骨 坒 
䯘	骨 完 
䯙	骨 甫 
䯚	骨 幺 ⺝ 
䯛	骨 宛 
䯜	骨 易 
䯞	骨 咼 
䯟	骨 㒸 
䯠	骨 昷 
䯡	骨 兼 
䯢	麻 骨 
䯣	骨 貴 
䯤	骨 會 
䯥	骨 㬎 
䯦	骨 蔑 
䯧	亠 口 冖 冋 
䯨	高 大 
䯪	高 頁 
䯫	景 高 
䯬	𩫏 單 
䯭	髟 又 
䯮	髟 乃 
䯯	髟 少 
䯰	髟 介 
䯱	髟 不 
䯲	髟 巴 
䯳	髟 公 
䯴	髟 殳 
䯵	髟 卉 
䯶	髟 且 
䯷	髟 戎 
䯸	髟 次 
䯺	髟 𠯑 
䯼	髟 狄 
䯽	髟 咅 
䯾	髟 周 
䯿	髟 卒 
䰀	髟 委 
䰁	髟 录 
䰂	髟 采 
䰃	髟 並 
䰄	髟 思 
䰆	髟 柔 
䰇	髟 者 
䰈	髟 差 
䰉	髟 般 
䰊	髟 尃 
䰋	髟 晏 
䰌	髟 從 
䰍	髟 桼 
䰎	髟 貴 
䰏	髟 截 
䰐	髟 監 
䰒	髟 蒙 
䰓	髟 臱 
䰔	髟 盤 
䰕	髟 盧 
䰖	髟 贊 
䰗	鬥 ⺈ 黾 
䰘	鬥 翏 
䰙	鬲 支 
䰚	鬲 文 
䰛	鬲 瓦 
䰜	弓 鬲 弓 
䰝	鬲 曾 
䰞	𩰲 者 
䰟	云 鬼 
䰠	鬼 申 
䰡	鬼 失 
䰢	鬼 行 
䰣	鬼 网 
䰤	東 鬼 
䰥	或 鬼 
䰦	鬼 卑 
䰧	鬼 虎 
䰨	鬼 眉 
䰩	者 鬼 
䰪	脊 鬼 
䰫	鬼 堯 
䰬	鬼 矞 
䰭	𦓔 鬼 
䰯	鬼 疑 
䰰	需 鬼 
䰱	靈 鬼 
䰲	魚 乚 
䱖	魚 丣 
䱗	𣦼 魚 
䱘	利 魚 
䱠	魚 戔 
䱡	魚 匊 
䱢	魚 争 
䱣	魚 卒 
䱤	魚 臽 
䱥	制 魚 
䱨	魚 刺 
䱫	剌 魚 
䱬	魚 胥 
䱭	魚 恆 
䱮	魚 契 
䱯	敄 魚 
䱰	魚 重 
䱱	魚 帝 
䱲	魚 彖 
䱳	魚 厘 
䱴	魚 恒 
䱵	魚 翁 
䱶	魚 良 ⻏ 
䱷	𫊣 攵 
䱸	魚 叟 
䱹	魚 差 
䱺	魚 豈 
䱻	魚 骨 
䱼	魚 展 
䱾	魚 婁 
䱿	魚 斬 
䲀	執 魚 
䲂	魚 旋 
䲃	魚 巢 
䲄	魚 敏 
䲅	魚 規 
䲉	魚 斯 
䲊	魚 隋 
䲋	魚 替 
䲌	魚 款 
䲍	舟 龹 魚 
䲎	魚 敢 
䲏	魚 勞 
䲐	魚 虜 
䲑	魚 義 
䲒	魚 解 
䲓	魚 僉 
䲔	魚 畺 
䲕	魚 普 
䲖	魚 壽 
䲘	魚 管 
䲙	魚 節 
䲚	魚 賴 
䲛	魚 瞢 
䲣	虍 鱼 攵 
䳒	𢦏 鳥 
䳖	鳥 耴 
䳗	鳥 我 
䳘	鳥 我 
䳙	甹 鳥 
䳚	旱 鳥 
䳛	妟 鳥 
䳜	余 鳥 
䳝	咅 鳥 
䳞	奉 鳥 
䳟	明 鳥 
䳠	垂 鳥 
䳡	隹 鳥 
䳢	其 鳥 
䳣	㦲 鳥 
䳤	㡀 鳥 
䳦	宣 鳥 
䳧	鳥 侯 
䳨	皇 鳥 
䳩	要 鳥 
䳪	耑 鳥 
䳫	癸 鳥 
䳬	革 鳥 
䳭	即 鳥 
䳮	脉 鳥 
䳯	重 鳥 
䳰	保 鳥 
䳱	務 鳥 
䳲	振 鳥 
䳳	祟 鳥 
䳵	來 力 鳥 
䳶	鳥 奚 
䳷	從 鳥 
䳸	麻 鳥 
䳹	鳥 寇 
䳺	酓 鳥 
䳻	斬 鳥 
䳼	鳥 區 
䳽	崔 鳥 
䳾	登 鳥 
䳿	然 鳥 
䴀	童 鳥 
䴁	寓 鳥 
䴂	象 鳥 
䴃	堯 鳥 
䴄	舜 鳥 
䴅	賁 鳥 
䴆	菐 鳥 
䴇	零 鳥 
䴊	義 鳥 
䴋	鳥 睘 
䴌	鳥 蒙 
䴍	賏 鳥 
䴎	畾 鳥 
䴏	燕 鳥 
䴐	寶 鳥 
䴑	疊 鳥 
䴒	靈 鳥 
䴚	鹵 亢 
䴛	鹵 肖 
䴜	鹵 鬼 
䴝	鹵 最 
䴞	鹵 翟 
䴟	鹿 凡 
䴠	鹿 夭 
䴢	鹿 木 
䴣	鹿 乎 
䴤	鹿 生 
䴥	鹿 加 
䴦	鹿 言 
䴧	鹿 委 
䴩	鹿 票 
䴪	鹿 祿 
䴫	鹿 零 
䴬	麥 弋 
䴭	麥 才 
䴮	麥 山 
䴯	麥 勿 
䴰	麥 戈 
䴱	麥 它 
䴲	麥 末 
䴳	麥 穴 
䴴	麥 占 
䴵	麥 并 
䴶	麥 夆 
䴷	麥 完 
䴸	麥 孚 
䴹	麥 果 
䴺	麥 咅 
䴻	𥝢 麥 
䴼	麥 戔 
䴽	麥 卑 
䴾	麥 差 
䴿	麥 冡 
䵁	麥 將 
䵂	麥 啇 
䵃	麥 黄 
䵄	麥 豊 
䵅	敖 麥 
䵆	麥 蒙 
䵇	麻 攵 
䵈	後 麻 
䵉	麻 俞 
䵊	丹 黄 
䵋	⻩ 有 
䵌	⻩ 夾 
䵎	⻩ 耑 
䵏	⻩ 翏 
䵐	⻩ 單 
䵑	黍 刃 
䵒	黍 日 
䵓	黍 牛 
䵔	黍 東 
䵕	黍 居 
䵖	臤 黍 
䵗	黍 畐 
䵘	黍 昜 
䵙	黍 奓 
䵚	黍 舀 
䵛	黍 堅 
䵜	黍 農 
䵝	黑 乚 
䵞	黑 刂 
䵟	黑 干 
䵠	黑 勺 
䵡	天 黑 
䵢	黑 未 
䵣	黑 旦 
䵤	开 黑 
䵥	黑 色 
䵦	黑 汙 
䵧	𢦏 黑 
䵨	黑 尨 
䵩	利 黑 
䵪	黑 昆 
䵫	宛 黑 
䵬	黑 沓 
䵭	黑 者 
䵮	黑 昜 
䵯	黑 重 
䵱	黑 喜 
䵲	黑 喿 
䵳	黑 會 
䵴	黑 黽 
䵵	𮅕 黑 
䵶	句 黽 
䵷	圭 黽 
䵹	知 于 黽 
䵺	土 鼎 
䵻	鼎 慧 
䵼	將 鼎 
䵽	鼓 去 
䵾	付 鼓 
䵿	鼓 占 
䶀	鼓 合 
䶁	鼓 沓 
䶂	鼠 勺 
䶃	鼠 今 
䶄	鼠 平 
䶅	鼠 各 
䶆	鼠 隹 
䶇	鼠 冑 
䶈	鼠 尃 
䶉	鼠 留 
䶊	鼻 丑 
䶋	鼻 及 
䶌	鼻 包 
䶍	至 鼻 
䶎	鼻 合 
䶏	弟 鼻 
䶐	鼻 會 
䶑	鼻 𤴡 
䶒	齊 女 
䶓	巾 齊 
䶔	齒 也 
䶕	齒 巴 
䶖	齒 今 
䶗	齒 可 
䶘	齒 立 
䶙	齒 巨 
䶚	齒 虫 
䶛	列 齒 
䶜	齒 告 
䶝	齒 夾 
䶞	齒 其 
䶟	齒 臽 
䶠	咸 齒 
䶡	齒 則 
䶢	齒 咸 
䶣	齒 豈 
䶤	齒 骨 
䶥	齒 虘 
䶦	齒 責 
䶧	齒 堯 
䶨	齒 僉 
䶩	齒 齊 
䶪	齒 截 
䶫	齒 嚴 
䶬	幵 龍 
䶰	龜 毛 
䶱	冬 龜 
䶲	冉 龜 
䶳	龠 亢 
䶴	炊 龠 
䶵	龠 虒 
䶸	口 么 
𠀀	一 ? 
𠀁	一 ㇉ 
𠀅	丂 丿 
𠀉	一 ? 
𠀓	引 一 
𠀕	互 丶 
𠀚	一 厼 
𠀛	一 𡗚 
𠀝	下 上 
𠀢	一 此 
𠀤	夶 一 
𠀦	一 州 
𠀬	㐁 人 
𠀮	一 八 龱 
𠀱	不 父 
𠀷	𠮛 𠕁 
𠀸	一 冂 夂 乞 
𠀹	一 八 同 
𠀼	𦣻 乂 
𠀽	𪩲 犮 
𠀾	不 会 
𠁉	一 凰 
𠁗	十 百 百 大 
𠁞	不 會 
𠁥	入 人 丨 
𠁰	𰀁 ⼹ 𰀄 
𠁽	乁 人 
𠂄	丹 曷 
𠂑	𠂎 丶 
𠂕	丿 夫 
𠂖	丯 一 
𠂝	丿 中 
𠂟	乊 𠂇 
𠂥	丿 𠕁 
𠂧	丿 儿 𠫔 
𠂳	凶 𢆯 
𠂷	夭 𢆉 
𠂸	丿 ⺇ 土 廾 
𠂹	亻 仌 仌 
𠂺	囟 廿 
𠃒	𠃊 十 
𠃔	𠂈 乚 
𠃖	工 ⺃ 
𠃞	一 巛 ⺃ 
𠃟	廿 ⺃ 
𠃤	𠀉 𫶧 
𠃥	⺄ 未 
𠃲	隹 ⺃ 
𠃳	九 呂 
𠃺	乙 首 
𠃼	囟 𠃟 
𠄃	杳 丂 乞 
𠄅	業 ⺃ 
𠄇	乳 各 
𠄈	粦 乙 乙 
𠄉	乳 重 
𠄋	𢀔 昍 𠂉 旦 乙 
𠄍	𠄌 亅 
𠄐	乛 亅 
𠄑	𠄌 ⺃ 亅 
𠄒	丿 才 
𠄖	令 丁 
𠄗	⺆ 土 了 
𠄚	釆 丂 丁 
𠄝	予 𤊱 
𠄞	一 一 
𠄟	一 一 
𠄠	一 一 
𠄡	𠄠 㐅 
𠄢	𠄠 囘 
𠄤	屯 二 
𠄮	𠄠 𢆶 
𠄰	二 囗 火 
𠄱	二 丨 臣 
𠄵	𠄠 昍 
𠄹	𠄠 敂 
𠄿	二 圍 
𠅃	亠 从 
𠅅	亠 朩 
𠅈	亠 丙 
𠅌	亠 口 大 
𠅔	亠 邑 
𠅖	亠 口 口 十 
𠅗	丁 夜 
𠅚	亠 使 
𠅞	亠 舛 几 
𠅟	亠 𠦜 几 
𠅠	亠 口 凵 亅 口 
𠅡	亠 口 𡰲 
𠅣	亢 夋 
𠅪	亢 玨 
𠅫	亠 㸚 几 
𠅬	亠 先 攴 
𠅱	勾 夜 
𠅹	亭 𢆰 
𠆁	亩 㼌 
𠆂	亠 口 𠆢 个 𠆢 个 
𠆌	亯 八 白 
𠆐	亠 䀠 灬 
𠆙	亭 夜 
𠆛	亠 暺 
𠆝	亠 昍 八 𠆢 戊 
𠆟	亠 𦥯 彖 
𠆣	一 人 
𠆤	𠆢 亅 
𠆦	𠃊 人 一 
𠆧	亻 人 
𠆩	亻 凡 
𠆮	亻 一 力 
𠆱	亻 十 丶 
𠆵	亻 兮 
𠆶	亻 冘 
𠇂	亻 囗 丶 
𠇋	𠆢 开 
𠇌	云 人 
𠇏	𠆢 今 
𠇒	亻 入 入 
𠇔	亻 毛 
𠇗	亻 瓜 
𠇘	亻 戉 
𠇮	𠆢 丙 
𠇯	𠆢 丘 
𠇱	亻 末 
𠇳	亻 大 几 
𠇵	亻 小 几 
𠇷	亻 生 
𠇸	亻 六 一 
𠇺	亻 甲 
𠇼	亻 乎 
𠈁	亻 𠂋 匕 
𠈅	亻 收 
𠈊	亻 𠂬 
𠈘	𠆢 圭 
𠈤	亻 小 女 
𠈥	亻 冎 
𠈬	亻 𪢶 
𠈭	亻 牢 
𠈰	亻 延 
𠈱	亻 沙 
𠈵	亻 尨 
𠈶	亻 岌 
𠈸	亻 忒 
𠈺	亻 坒 
𠉂	亻 达 
𠉗	亻 乱 
𠉢	亻 囦 
𠉣	亻 昏 
𠉤	亻 沓 
𠉧	亻 取 
𠉩	亻 毒 
𠉬	亻 吅 厂 
𠊉	会 勿 
𠊌	𠆢 炎 
𠊎	亻 厓 
𠊏	亻 𠜎 
𠊒	亻 广 匕 夂 
𠊔	亻 泣 
𠊣	亻 丑 丑 
𠊤	亻 虍 人 
𠊥	亻 沝 
𠊦	亻 巛 正 
𠊧	亻 並 
𠊩	亻 孨 
𠊪	亻 壴 
𠊫	亻 㝁 
𠊬	亻 卻 
𠊭	亻 咸 
𠊰	亻 咼 
𠊱	亻 矦 
𠊲	亻 突 
𠊵	亻 𭖚 
𠊷	亻 𦤶 
𠊾	亻 癸 
𠋖	亻 柬 
𠋜	亻 ⺌ 一 一 一 口 
𠋝	亻 眇 
𠋞	亻 虵 
𠋟	亻 臾 
𠋡	亻 食 
𠋢	亻 叜 
𠋣	亻 竒 
𠋤	亻 室 
𠋧	亻 恒 
𠋩	亻 㚆 
𠋬	亻 狊 
𠋭	亻 㐬 口 
𠋯	亻 舀 
𠋲	亻 索 
𠋵	亻 虔 
𠋶	亻 冥 
𠋷	亻 蚩 
𠋺	亻 蚤 
𠋻	亻 畟 
𠌖	亻 𣑦 
𠌞	亻 丿 且 友 
𠌟	亻 白 皮 
𠌠	亻 爫 至 
𠌥	亻 烏 
𠌪	攸 目 
𠌭	亻 率 
𠌮	亻 庶 
𠌯	亻 离 
𠌰	亻 既 
𠌱	亻 奞 
𠌲	亻 斬 
𠌴	亻 舂 
𠌶	𠂹 亏 
𠍃	亻 飢 
𠍄	亻 𠁁 
𠍐	令 狐 
𠍗	合 𦥑 
𠍙	亻 王 呆 
𠍚	亻 百 龱 
𠍛	亻 百 冂 女 
𠍜	代 直 
𠍦	亻 䝨 
𠍨	亻 麻 
𠍪	亻 豕 灬 
𠍫	亻 欷 
𠍯	亻 敝 
𠍲	亻 渠 
𠍳	龷 𠆢 个 𠆢 个 
𠍵	亻 羕 
𠍹	亻 答 
𠍽	亻 奢 
𠎒	亻 悶 
𠎙	來 合 
𠎝	亻 㚘 心 
𠎮	亻 厥 
𠎰	亻 戈 卅 心 
𠎶	未 成 𠆢 
𠎷	亻 䪞 
𠎸	亻 嗇 
𠎻	亻 遁 
𠎿	亻 解 
𠏀	亻 過 
𠏃	亻 蛾 
𠏇	亼 丨 𢆶 田 
𠏓	倉 台 
𠏕	亻 楆 
𠏖	亻 大 羔 
𠏚	亻 愈 
𠏛	亻 广 共 方 
𠏡	亻 零 
𠏢	亻 亂 
𠏧	倉 令 
𠏨	亻 䆫 
𠏩	亻 訔 欠 
𠏫	亻 臣 子 皿 
𠏮	亻 對 
𠏰	亻 廌 
𠏿	亻 鼻 
𠐀	亻 歋 
𠐁	亻 蒙 
𠐈	亻 臱 
𠐉	亻 節 
𠐊	亻 豎 
𠐋	亻 膠 
𠐌	亻 罷 
𠐍	亻 數 
𠐑	亻 𤴡 
𠐡	亻 輩 
𠐧	亻 瞢 
𠐩	亻 閻 
𠐲	亻 𢨋 
𠐺	亻 頻 
𠐻	亻 蹇 
𠐼	亻 臨 
𠐾	亻 䫏 
𠑃	亻 吉 鳥 
𠑄	亻 燮 
𠑅	亻 䆸 
𠑆	亻 門 臿 
𠑑	亻 𨶒 
𠑘	亻 顛 
𠑙	亻 寵 
𠑛	亻 茍 冖 止 攵 
𠑞	亻 ⻍ 臾 艮 
𠑟	亻 邊 
𠑡	亻 門 𪺏 
𠑪	亻 囂 
𠑯	亻 土 韭 頁 
𠑱	會 景 
𠑴	合 䖵 清 
𠑶	一 𠃊 儿 
𠑷	上 儿 
𠑺	一 宀 儿 
𠑻	コ 亠 儿 
𠑽	亠 口 儿 
𠑾	⺈ 尸 儿 
𠒄	出 兀 
𠒆	囟 儿 
𠒌	艹 圥 
𠒍	臼 丿 乙 
𠒜	元 皃 
𠒝	光 丙 
𠒢	元 兔 
𠒧	棘 儿 
𠒨	充 京 
𠒰	兒 男 
𠒱	辟 儿 
𠒵	光 柬 
𠒸	息 光 
𠒾	免 毒 
𠒿	光 啇 
𠓆	丰 兄 丰 兄 
𠓊	光 單 
𠓋	光 睪 
𠓌	光 廉 
𠓖	光 闌 
𠓛	入 一 
𠓝	入 十 
𠓞	入 二 
𠓟	入 乞 
𠓡	入 亓 
𠓢	入 手 
𠓣	入 心 
𠓤	入 一 日 
𠓫	入 兵 
𠓭	入 林 
𠓮	入 靣 
𠓱	入 𢆶 大 
𠓲	入 桀 
𠓴	全 丣 
𠓵	入 𡙁 
𠓶	帶 入 
𠓷	入 爽 
𠓸	入 兓 木 
𠓽	入 輩 
𠓿	入 非 匪 
𠔀	八 一 
𠔂	刂 八 
𠔃	丷 丂 
𠔈	八 中 
𠔊	丘 八 
𠔋	八 龱 
𠔌	八 八 口 
𠔍	八 由 
𠔎	八 𠆢 𰀁 
𠔑	分 分 
𠔒	八 𦥑 
𠔓	𡆪 一 八 
𠔔	由 六 
𠔕	分 𠕁 
𠔖	艸 一 八 
𠔚	𠫓 共 
𠔛	凵 𪠲 一 八 
𠔟	八 隻 
𠔠	分 亟 
𠔨	乆 兼 
𠔯	八 菐 
𠔲	八 𠆢 公 儿 夫 
𠔶	其 真 
𠔸	冨 其 
𠔹	𦥯 共 
𠔺	兼 咸 
𠔼	冂 一 
𠔽	冂 冂 
𠔾	𰃦 一 
𠕁	冂 卄 
𠕃	冂 亡 
𠕅	一 冄 
𠕊	𠔼 丁 
𠕋	冂 井 
𠕌	冂 日 
𠕍	丶 冂 𢌬 
𠕐	冂 出 
𠕑	冂 亠 口 
𠕕	冂 叧 
𠕖	⺜ 木 
𠕘	冂 丶 丶 丶 小 
𠕛	⺆ 丰 口 
𠕝	⺜ 多 
𠕟	冉 占 
𠕠	⺜ 成 
𠕣	⺜ 臽 
𠕤	⺜ 兔 
𠕥	⺜ 到 
𠕦	⺜ 俞 
𠕧	知 冋 
𠕨	冏 余 
𠕩	冎 卑 
𠕭	⺜ 棹 
𠕮	⺜ 糸 彳 于 
𠕰	⺜ 爾 
𠕳	冖 入 
𠕴	冖 九 
𠕸	冖 夂 
𠕻	冖 元 
𠕿	冖 化 
𠖂	𠕴 幺 
𠖄	冖 同 
𠖆	冖 日 𠤎 
𠖋	冖 八 田 
𠖓	冖 思 
𠖛	冖 聊 
𠖟	冖 剽 
𠖥	冖 龍 
𠖫	冖 贑 
𠖬	冫 ⺃ 
𠖶	冫 心 
𠖷	冫 冋 
𠖹	冫 甲 
𠗂	冫 各 
𠗈	冫 求 
𠗉	冫 夾 
𠗊	冫 巠 
𠗋	冫 忍 
𠗌	冫 克 
𠗏	冫 身 
𠗘	冫 典 
𠗙	冫 函 
𠗚	冫 卒 
𠗛	冫 𣏋 
𠗝	冫 㸒 
𠗥	冫 音 
𠗦	冫 𮩴 
𠗨	冫 枼 
𠗳	冫 兼 
𠗴	冫 圅 
𠗵	冫 旁 
𠗶	冫 唐 
𠗺	冫 移 
𠗻	冫 堅 
𠗼	冫 戚 
𠗽	冫 翏 
𠗾	冫 爽 
𠗿	冫 參 
𠘁	冫 部 
𠘂	冫 欶 
𠘅	冫 禽 
𠘆	冫 森 
𠘊	冫 農 
𠘋	冫 鼎 
𠘌	冫 畺 
𠘕	冫 熙 
𠘖	冫 質 
𠘝	冫 賴 
𠘞	冫 隷 
𠘟	冫 歷 
𠘢	冫 鹵 舟 
𠘣	冫 爵 
𠘪	⺇ 九 
𠘱	⺇ 彡 
𠘳	⺇ 山 
𠘺	𠫓 几 
𠙁	正 几 
𠙂	几 只 
𠙆	𠫤 几 
𠙎	朱 几 
𠙔	⺇ 白 工 
𠙕	⺇ 出 口 
𠙞	要 几 
𠙠	𠆢 𠈌 几 
𠙤	几 接 
𠙬	⺇ 𢆶 䖝 
𠙼	凵 口 
𠚃	一 凵 口 
𠚄	凵 仌 
𠚅	凵 公 
𠚆	凹 丨 
𠚉	凵 禾 
𠚊	凵 必 
𠚓	凵 又 吉 
𠚔	龴 一 凵 合 
𠚠	凵 𭥭 𭥭 
𠚣	㇉ 丿 
𠚥	刀 刂 
𠚧	二 刂 
𠚨	丩 刀 
𠚭	勺 刂 
𠚮	刀 乞 
𠚯	兀 刂 
𠚱	𠧒 刀 
𠚳	广 刂 
𠚴	巛 刂 
𠚵	及 刂 
𠚹	殳 刂 
𠚺	少 刂 
𠚻	𠂉 刁 刂 
𠚼	分 刂 
𠚽	支 刂 
𠛀	公 刂 
𠛃	龵 刂 
𠛆	乌 刂 
𠛊	氏 刂 
𠛋	巴 刂 
𠛎	句 刂 
𠛑	玄 刂 
𠛒	瓜 刂 
𠛓	卯 刂 
𠛔	𠂔 刂 
𠛕	屶 刂 
𠛖	𬺻 刂 
𠛘	大 乃 刂 
𠛙	北 刂 
𠛚	又 巾 刂 
𠛡	必 刂 
𠛢	乍 刂 
𠛥	丙 刂 
𠛦	丿 尢 丶 刂 
𠛩	糹 刂 
𠛪	兆 刂 
𠛫	多 刂 
𠛬	幵 刂 
𠛭	因 刂 
𠛮	全 刂 
𠛱	𡿪 刂 
𠛳	亥 刀 
𠛵	艮 刂 
𠛶	八 文 刂 
𠛸	中 分 
𠜁	夷 刂 
𠜃	臼 刂 
𠜄	血 刂 
𠜅	交 刂 
𠜈	聿 刂 
𠜉	丞 刂 
𠜋	𠆢 丑 刂 
𠜎	先 刂 
𠜐	⺊ 𠕁 刂 
𠜑	兌 刂 
𠜖	寽 刂 
𠜗	希 刂 
𠜙	甫 刂 
𠜤	圭 刃 
𠜲	亞 刂 
𠜳	朋 刂 
𠜴	果 刂 
𠜵	㓞 夬 
𠜶	𣥕 刂 
𠜹	𰥍 刂 
𠜼	臽 刂 
𠜾	屈 刂 
𠝄	爫 勿 刂 
𠝐	花 刂 
𠝑	𫵖 刂 
𠝘	备 刂 
𠝚	龷 木 刂 
𠝛	去 口 刂 
𠝝	枼 刂 
𠝞	臿 刂 
𠝟	英 刂 
𠝢	弇 刂 
𠝤	重 刂 
𠝨	彳 刹 
𠝪	処 口 刂 
𠝬	叜 刂 
𠝲	香 刂 
𠝳	宣 刂 
𠝽	刀 夗 曰 
𠞀	窋 刂 
𠞃	芻 刂 
𠞄	虒 刂 
𠞆	烏 刂 
𠞈	⺜ 羽 刂 
𠞉	栗 刂 
𠞊	差 刂 
𠞕	重 刃 
𠞖	貢 刂 
𠞗	去 去 刂 
𠞙	禾 尒 刂 
𠞞	舀 刂 
𠞤	巛 冂 氺 刂 
𠞧	麻 刀 
𠞩	率 刂 
𠞬	袞 刂 
𠞭	婁 刂 
𠞮	爽 刂 
𠞯	雪 刂 
𠞰	巢 刀 
𠞱	堇 刂 
𠞵	⺫ 伐 刂 
𠞶	啇 刂 
𠞾	彳 釗 
𠞿	𧴵 刂 
𠟂	曾 刂 
𠟄	厤 刀 
𠟅	䇪 刂 
𠟈	敝 刀 
𠟉	孱 刂 
𠟊	翕 刂 
𠟋	堯 刂 
𠟍	童 刂 
𠟓	貲 刂 
𠟗	⻀ 冖 𢀛 刂 
𠟟	詈 刂 
𠟣	幾 刂 
𠟦	瑟 刂 
𠟧	詹 刂 
𠟨	零 刂 
𠟩	嗇 刂 
𠟪	業 刂 
𠟰	𥇛 刂 
𠟶	窟 刂 
𠟺	需 刂 
𠟻	貝 貝 刂 
𠠁	㬎 刂 
𠠃	从 一 韭 刂 
𠠄	走 削 
𠠋	𣦼 則 
𠠍	黎 刂 
𠠎	廣 刂 
𠠏	厲 刂 
𠠐	壽 刃 
𠠔	賣 刀 
𠠗	巤 刂 
𠠜	罃 刂 
𠠝	歷 刂 
𠠠	賣 刃 
𠠢	霝 刀 
𠠪	䜌 刀 
𠠯	疊 刂 
𠠳	丩 力 
𠠵	九 力 
𠠶	乞 力 
𠠷	𠃔 力 
𠠹	冘 力 
𠡀	丆 又 力 
𠡂	弗 力 
𠡄	皮 力 
𠡊	𡗜 力 
𠡑	汋 力 
𠡒	𠂤 力 
𠡔	巛 万 力 
𠡜	充 力 
𠡝	𡿪 力 
𠡞	皃 力 
𠡡	𣦼 力 
𠡣	更 力 
𠡤	㐬 力 
𠡥	力 兵 
𠡭	夌 力 
𠡮	朋 力 
𠡱	⺌ 旦 力 
𠡶	劵 力 
𠡷	劦 木 
𠡸	事 力 
𠡻	怱 力 
𠢃	昜 力 
𠢆	害 力 
𠢇	𠦝 𠂉 力 
𠢌	𡗗 劭 
𠢍	虔 力 
𠢓	莫 力 
𠢔	區 力 
𠢕	敖 力 
𠢙	笞 力 
𠢚	眷 力 
𠢛	弓 受 力 
𠢠	棘 力 
𠢡	答 力 
𠢢	柔 幼 
𠢣	劣 典 
𠢤	厥 力 
𠢥	費 力 
𠢩	堯 力 
𠢪	敝 力 
𠢱	禁 力 
𠢲	解 力 
𠢳	嗇 力 
𠢴	⺈ 黒 力 
𠢵	禁 力 
𠢹	廣 力 
𠣄	毚 力 
𠣇	劣 輦 
𠣉	需 勉 
𠣊	非 慮 力 
𠣐	勹 亠 丿 
𠣑	勹 元 
𠣒	勹 仁 
𠣕	勹 主 
𠣖	勹 玄 
𠣘	勹 舟 
𠣠	勹 ⺊ 𠕁 
𠣡	勹 八 旦 
𠣫	召 句 
𠣬	旬 八 丂 
𠣰	勹 者 
𠣲	勹 艹 𠙽 
𠣳	卓 勺 
𠣺	冫 匕 木 包 
𠣾	勹 復 
𠣿	勹 㲃 
𠤀	⺈ 目 夂 勿 
𠤄	勹 竹 幸 
𠤊	勹 窮 
𠤍	勹 雚 
𠤎	乚 丿 
𠤏	匕 十 
𠤕	匕 矢 
𠤘	匕 矣 
𠤝	龸 二 匕 
𠤦	北 穴 允 
𠤮	匚 今 
𠤰	匚 公 
𠤴	匚 只 
𠤹	匚 全 
𠤼	匚 攸 
𠤾	匚 吟 
𠥇	匸 言 
𠥊	匚 其 
𠥍	匚 阿 
𠥎	匚 韋 
𠥐	匚 倉 
𠥑	匚 條 
𠥕	匚 盍 
𠥖	匚 帶 
𠥘	匚 𧴵 
𠥙	匚 尊 
𠥜	匚 歇 
𠥝	匚 品 殳 
𠥞	匚 ⺊ 目 全 
𠥢	匚 舞 
𠥦	匚 翼 
𠥧	𠥓 否 
𠥨	匚 蟲 
𠥩	𠥓 其 
𠥪	𠥓 舀 
𠥫	𠥓 臱 
𠥰	匸 卯 
𠥴	匸 汵 
𠥿	㔾 十 
𠦃	十 卄 
𠦈	井 十 
𠦊	云 十 
𠦋	上 千 
𠦌	卄 卄 
𠦎	八 八 十 
𠦏	十 从 
𠦐	十 𠘬 
𠦗	十 㠯 
𠦜	廿 廿 
𠦡	土 𢆉 
𠦧	幸 十 
𠦨	⺈ 屮 𠚣 十 
𠦪	𠦄 夲 
𠦫	咠 十 
𠦬	千 𠈌 
𠦲	卓 升 
𠧀	獁 十 
𠧅	咼 卑 
𠧇	卓 舁 
𠧒	⺊ 乙 
𠧕	上 尸 
𠧖	⺊ 贝 
𠧙	召 卜 
𠧚	⺊ 囚 
𠧛	上 尺 
𠧞	兆 卜 
𠧟	𠃊 卤 
𠧠	𠃊 卣 
𠧩	每 卜 
𠧫	⺊ 日 夂 
𠧰	⺊ 冂 二 口 
𠧴	𠃊 𠧪 
𠧵	𠧚 大 
𠧿	⺊ 𦉪 失 
𠨃	男 外 
𠨆	⺊ 𦉪 工 丙 
𠨊	冓 外 
𠨎	㔾 㔾 
𠨐	匕 卩 
𠨒	比 卩 
𠨘	必 卩 
𠨚	希 卩 
𠨠	即 久 
𠨢	危 夋 
𠨥	𠂎 聊 
𠨭	厂 𰀁 
𠨲	屮 厂 
𠨵	厂 丰 
𠨻	厂 殳 
𠨾	厂 手 
𠨿	厂 氏 
𠩂	厂 去 
𠩄	厂 リ 𠂉 亅 
𠩆	厂 此 
𠩈	厂 主 
𠩉	厂 出 
𠩏	厂 尗 
𠩔	灰 𠤎 
𠩕	厂 米 
𠩗	厂 㳄 
𠩘	厂 夾 
𠩠	厂 貝 
𠩥	厂 呈 
𠩧	厂 今 止 
𠩪	厂 刺 
𠩫	厂 兒 
𠩵	厂 林 
𠩷	厂 典 
𠩺	未 攵 厂 
𠩿	厂 𭺾 
𠪂	厂 扁 
𠪃	厂 眉 
𠪄	厂 苗 
𠪇	厂 叟 
𠪐	厂 留 
𠪑	厂 埶 
𠪒	厂 口 金 
𠪗	厂 䚿 
𠪘	厂 𣪏 
𠪙	厂 異 
𠪚	厂 敢 
𠪟	厂 艮 缶 
𠪢	厂 欽 
𠪣	厂 散 
𠪧	厂 巴 果 
𠪮	厂 辟 
𠪲	厂 勤 
𠪶	厂 死 豆 
𠪷	厂 暈 
𠪺	厤 分 
𠫃	厂 幸 罙 
𠫄	厂 羊 丷 口 令 
𠫉	厂 顚 
𠫎	厂 䀠 犬 金 
𠫐	厂 灥 
𠫓	厶 一 
𠫘	厶 十 
𠫛	厶 𠫔 
𠫜	厶 ⺄ 力 
𠫝	厶 𫶧 
𠫣	厶 内 
𠫤	㐅 厷 
𠫨	厸 凡 
𠫮	厶 日 几 
𠫶	厶 里 
𠫷	𠫤 丸 
𠫸	厶 厶 丨 丨 厶 丨 
𠬆	㕕 小 糸 
𠬈	去 卑 
𠬋	厸 星 
𠬓	㕘 兄 
𠬙	參 兩 
𠬛	刀 又 
𠬝	卩 又 
𠬞	丩 又 
𠬢	屮 又 
𠬪	爫 又 
𠬬	八 及 
𠬮	𠃜 又 
𠬶	⺕ 冖 又 
𠬸	囘 又 
𠬾	又 𢆶 
𠭈	司 冖 又 
𠭉	⺊ 用 又 
𠭋	叕 㔾 
𠭖	爫 又 古 
𠭘	𣦼 井 
𠭙	𢑚 又 
𠭥	祟 又 
𠭯	虘 又 
𠭰	𠩺 又 
𠭴	叕 出 
𠭹	貞 㕛 
𠭿	一 勿 日 巾 又 
𠮃	辟 又 
𠮆	双 敗 
𠮊	㝵 取 
𠮌	叕 臽 
𠮑	鞠 又 
𠮙	口 乙 
𠮜	口 ⺃ 
𠮟	口 七 
𠮡	口 二 
𠮦	丷 口 
𠮭	口 勺 
𠮯	己 口 
𠮰	口 巛 
𠮱	口 亏 
𠮳	上 口 
𠮴	下 口 
𠮵	口 上 
𠮷	土 口 
𠮹	口 才 
𠮽	口 廾 
𠮾	口 兀 
𠮿	口 山 
𠯀	口 川 
𠯂	口 子 
𠯃	𠙼 亅 
𠯄	口 刃 
𠯈	口 大 
𠯉	召 一 
𠯋	口 兮 
𠯍	口 冄 
𠯐	口 日 
𠯑	氏 口 
𠯓	斤 口 
𠯔	口 匹 
𠯗	口 帀 
𠯘	口 反 
𠯙	口 尐 
𠯜	口 勾 
𠯣	口 之 
𠯩	口 扎 
𠯪	口 歹 
𠯫	口 戈 
𠯭	口 日 
𠯯	口 片 
𠯰	口 什 
𠯱	口 入 入 
𠯲	口 月 
𠯳	勿 口 
𠯴	口 卞 
𠯷	口 乃 厶 
𠯸	口 厂 丁 
𠯹	口 仍 
𠯿	口 六 
𠰄	口 予 
𠰅	口 手 
𠰈	口 弘 
𠰉	口 召 
𠰋	口 丘 
𠰍	口 主 
𠰏	口 乏 
𠰐	口 叵 
𠰑	口 厈 
𠰓	口 禾 
𠰕	出 口 
𠰖	口 𦫼 
𠰚	口 𠂉 小 
𠰛	山 古 
𠰢	口 半 
𠰳	口 丙 
𠰴	口 石 
𠰹	口 㐌 
𠰺	口 代 
𠰻	口 外 
𠰼	口 市 
𠰽	口 宂 
𠰾	口 凥 
𠱀	口 皮 
𠱐	口 呉 
𠱑	口 大 口 
𠱓	口 危 
𠱔	口 守 
𠱗	亠 口 冄 
𠱘	口 屰 
𠱙	口 尗 
𠱚	口 𠧗 
𠱛	刀 冏 
𠱜	口 存 
𠱝	口 䏍 
𠱞	口 杂 
𠱡	口 𠕋 
𠱤	口 耒 
𠱥	口 卉 
𠱧	𠇊 口 
𠱨	口 𠃨 
𠱯	吅 工 
𠱲	口 𢑑 
𠱳	口 弜 
𠲊	口 土 夂 
𠲋	口 朿 
𠲌	口 戍 
𠲍	口 丢 
𠲎	口 伐 
𠲏	口 任 
𠲑	半 口 ? 
𠲒	𠇍 口 
𠲓	口 夅 
𠲖	口 衣 
𠲙	口 尸 九 丶 
𠲚	口 孖 
𠲛	口 回 
𠲜	口 爭 
𠲥	口 礼 
𠲮	口 巠 
𠲱	丰 各 
𠲴	口 投 
𠲵	口 劫 
𠲷	口 𦔮 
𠲹	口 忌 
𠲺	口 岌 
𠲻	沂 口 
𠲽	口 佛 
𠲾	口 䀏 
𠲿	口 束 
𠳀	口 甬 
𠳁	口 困 
𠳂	口 𠯑 
𠳃	口 汞 
𠳆	𢦒 口 
𠳇	听 口 
𠳊	可 去 
𠳋	𠀐 㠯 
𠳌	去 可 
𠳎	口 似 
𠳭	口 克 
𠳳	口 呆 
𠳴	口 中 女 
𠳶	口 禾 几 
𠳹	口 床 
𠳼	口 宋 
𠳽	口 穴 丁 
𠳾	口 罕 
𠳿	口 尾 
𠴂	口 努 
𠴄	口 糸 ⺃ 
𠴇	口 兵 
𠴡	口 皃 
𠴢	口 声 
𠴣	口 丷 句 
𠴦	句 主 
𠴨	口 官 
𠴩	口 其 
𠴫	口 叔 
𠴭	口 易 
𠴯	口 丿 巫 
𠴱	口 固 
𠴲	口 沓 
𠴳	口 肴 
𠴵	口 帚 
𠴸	波 口 
𠴹	口 泣 
𠴺	口 𠒆 
𠴻	口 陁 
𠴼	口 到 
𠴾	口 丑 丑 
𠵓	口 ? 
𠵘	口 門 
𠵠	口 一 否 
𠵣	口 軋 
𠵦	吾 午 
𠵨	口 㝵 
𠵩	口 果 
𠵫	口 昂 
𠵬	品 又 
𠵭	口 𦙃 
𠵮	口 牪 
𠵯	口 刮 
𠵳	后 㞋 
𠵷	口 六 允 
𠵸	口 弥 
𠵹	口 岡 
𠵺	口 爫 巴 
𠵻	口 宗 
𠵾	口 画 
𠶜	口 制 
𠶨	口 炙 
𠶫	口 大 氶 
𠶬	吅 一 龷 
𠶰	⺈ 丶 周 
𠶱	可 各 
𠶲	口 厒 
𠶷	咅 中 
𠶸	口 卻 
𠶹	口 紇 
𠶻	口 咠 
𠶾	口 苛 
𠶿	口 羍 
𠷀	口 耎 
𠷁	口 前 
𠷂	口 怠 
𠷃	口 叜 
𠷄	口 𢈊 
𠷅	口 茁 
𠷇	口 施 
𠷈	口 律 
𠷉	口 迦 
𠷊	口 便 
𠷋	口 厚 
𠷌	口 則 
𠷎	𢏚 口 
𠷏	丸 咼 
𠷐	口 恒 
𠷑	口 癹 
𠷒	𫩜 目 
𠷓	甹 只 
𠷖	口 窆 
𠷞	卵 古 
𠷟	口 界 
𠷠	石 戈 口 
𠷢	口 𦈢 亍 
𠷨	口 扁 
𠷸	口 壴 
𠷺	口 勃 
𠷻	哂 寸 
𠷿	口 怎 
𠸁	口 派 
𠸂	口 突 
𠸄	口 英 
𠸍	口 美 
𠸮	甹 号 
𠸱	口 丨 口 示 
𠸲	一 厸 冏 
𠸳	口 陋 
𠸴	口 戈 工 八 
𠸸	口 唇 
𠸹	口 彧 
𠸺	口 逆 
𠹀	口 孫 
𠹁	口 窊 
𠹃	口 盎 
𠹄	口 圅 
𠹅	口 恭 
𠹆	口 眈 
𠹈	吅 里 
𠹊	口 草 
𠹋	口 疾 
𠹌	口 能 
𠹍	口 容 
𠹎	口 烋 
𠹐	口 夎 
𠹑	口 臬 
𠹓	口 戶 缶 
𠹔	口 唐 
𠹕	口 豹 
𠹖	口 展 
𠹘	口 ⺊ 目 夊 
𠹛	口 豈 
𠹝	林 九 口 
𠹟	宀 𠀎 八 口 
𠹠	口 臼 木 
𠹤	口 恚 
𠹥	口 ⺜ 羽 
𠹦	口 比 糸 
𠹭	口 哥 
𠺐	吅 見 
𠺒	口 息 
𠺔	口 𰢱 
𠺕	口 留 
𠺖	口 畝 
𠺗	口 迷 
𠺙	口 退 
𠺚	口 班 
𠺟	口 庫 
𠺢	口 家 
𠺣	口 剝 
𠻍	口 臽 又 
𠻐	口 珞 
𠻙	口 𡇶 
𠻚	莫 口 
𠻜	口 率 
𠻝	品 㐱 
𠻞	口 康 
𠻟	口 桼 
𠻠	口 聆 
𠻡	𣂞 口 
𠻤	口 寅 
𠻥	口 巢 
𠻦	口 𡕩 
𠻧	口 梏 
𠻨	口 堇 
𠻪	口 淡 
𠻫	口 悥 
𠻬	口 荼 
𠻱	口 陵 
𠻳	口 敕 
𠻴	口 朗 
𠼖	口 婪 
𠼗	口 斬 
𠼘	口 五 吾 
𠼝	口 梨 
𠼞	合 亞 
𠼟	口 八 面 
𠼠	口 氏 貝 
𠼡	𢏚 叹 
𠼢	口 強 
𠼤	口 堅 
𠼩	口 崙 
𠼪	口 移 
𠼬	口 商 
𠽜	口 啻 
𠽝	吅 典 
𠽡	口 惠 
𠽣	口 㞚 
𠽦	口 減 
𠽨	口 𡩘 
𠽩	口 筆 
𠽪	口 湆 
𠽫	口 閕 
𠽬	口 貳 
𠽰	口 寔 
𠽱	口 寋 
𠽲	口 釆 皿 
𠽵	口 𧯡 
𠽶	口 毳 
𠽷	口 貲 
𠽹	口 𧦴 
𠽻	口 喆 
𠽼	口 歰 
𠽾	口 普 
𠽿	口 辜 
𠾀	口 𰕎 
𠾆	口 犂 
𠾇	口 厨 
𠾉	𢏚 吋 
𠾋	口 𭪿 
𠾌	口 屰 臼 
𠾏	口 奢 
𠾐	口 隆 
𠾢	口 尌 
𠾤	森 口 
𠾥	哥 令 
𠾨	口 嵌 
𠾩	口 山 曷 
𠾫	口 須 
𠾬	口 欽 
𠾮	口 䆤 
𠾲	口 越 
𠿇	口 解 
𠿈	口 愁 
𠿉	𣪠 口 
𠿋	口 粵 
𠿏	口 煎 
𠿑	口 感 
𠿓	口 䪞 
𠿔	口 彖 心 
𠿕	喬 亢 
𠿗	口 瑟 
𠿘	口 雋 
𠿛	口 虜 
𠿜	口 㼫 
𠿝	口 楚 
𠿞	口 亶 
𠿟	𦥯 口 
𠿠	口 戢 
𠿡	窡 口 
𠿢	口 羨 
𠿣	口 歅 
𠿤	口 鼓 
𠿥	口 𦞅 
𡀇	口 董 
𡀑	口 輈 
𡀖	口 鉢 
𡀗	口 詩 
𡀘	口 嫈 
𡀙	口 窟 
𡀹	口 筫 
𡀺	口 䝱 
𡀽	口 蓋 
𡀾	口 㬎 
𡀿	口 屢 
𡁀	口 𣣻 
𡁁	口 㪡 
𡁆	口 犖 
𡁇	口 綽 
𡁈	口 辡 
𡁉	嗎 中 
𡁊	口 𡠺 
𡁋	口 㥯 
𡁌	口 䯉 
𡁍	口 𣣶 
𡁎	口 與 
𡁏	口 蒙 
𡁓	口 耎 瓦 
𡁔	口 精 
𡁕	口 翣 
𡁧	口 臧 
𡁨	對 口 
𡁪	口 ⺫ 則 
𡁮	口 窩 
𡁰	口 𦂝 
𡁱	口 熙 
𡁳	單 犮 
𡁴	口 團 
𡂊	口 𠆢 淼 
𡂒	口 質 
𡂓	口 適 
𡂕	口 蓼 
𡂖	口 厲 
𡂗	口 隹 冏 
𡂘	口 麃 
𡂙	口 遲 
𡂚	口 𤇾 目 
𡂛	口 門 豆 
𡂝	口 賣 
𡂟	喿 包 
𡂡	口 數 
𡂢	口 鳥 木 
𡂩	口 𦖩 
𡂫	口 蓬 
𡂭	口 辶 庻 
𡂿	口 歐 
𡃂	口 宀 舃 
𡃃	口 緝 
𡃄	口 賚 
𡃅	口 瑩 
𡃆	口 層 
𡃇	口 弊 
𡃈	口 緙 
𡃓	口 播 
𡃖	口 慮 
𡃝	口 論 
𡃡	龍 口 
𡃢	口 暨 
𡃦	口 閵 
𡃩	口 褱 
𡃳	口 興 
𡃵	口 擁 
𡃷	吅 雷 
𡃸	口 此 鳥 
𡄇	口 磬 
𡄑	口 韱 
𡄒	殸 老 口 
𡄓	口 蹇 
𡄔	口 聲 
𡄕	口 燮 
𡄖	口 應 
𡄟	口 霞 
𡄡	口 齋 
𡄢	口 闍 
𡄣	口 彌 
𡄤	口 還 
𡄱	口 蹙 
𡄲	如 嘼 
𡄴	口 巂 
𡄷	口 鞮 
𡄻	壹 咨 
𡅂	口 鵓 
𡅃	口 龎 
𡅄	亭 單 
𡅅	口 額 
𡅆	口 藏 
𡅇	口 叢 
𡅓	口 亠 癶 丫 果 
𡅕	𠶮 𠶮 
𡅖	各 養 
𡅘	口 臘 
𡅙	口 韻 
𡅡	噩 各 
𡅥	口 顛 
𡅭	口 關 
𡅱	㗊 𦰩 
𡅵	口 釋 
𡅶	口 騫 
𡅹	口 京 亶 
𡅺	口 霵 
𡅻	㗊 萈 
𡆆	口 攞 
𡆏	口 𨷖 
𡆕	口 戀 
𡆢	囗 〆 
𡆣	囗 入 
𡆤	囗 二 
𡆥	囗 卜 
𡆦	囗 八 
𡆩	囗 幺 
𡆬	囗 工 
𡆮	囗 士 
𡆯	囗 山 
𡆱	囗 彡 
𡆲	囗 亡 
𡆸	囗 丐 
𡆽	囗 兮 
𡇀	囗 殳 
𡇂	囗 火 
𡇄	囗 双 
𡇅	囗 方 
𡇈	囗 石 
𡇑	囗 㠯 
𡇒	囗 米 
𡇓	囗 至 
𡇖	囗 臣 
𡇚	囗 百 
𡇜	囗 ⾆ 
𡇝	囗 自 
𡇞	囗 合 
𡇟	囗 𢆶 
𡇠	囗 皀 
𡇤	丷 固 
𡇦	囗 龶 女 
𡇧	囗 豆 
𡇩	囗 山 仉 
𡇬	囗 丷 正 
𡇭	囗 女 一 女 
𡇮	囗 甬 
𡇯	囗 束 
𡇰	囗 六 允 
𡇱	囗 石 口 
𡇳	囗 命 
𡇵	囗 宕 
𡇶	龴 囗 合 
𡇷	丷 囗 各 
𡇸	囗 乖 
𡇺	囗 允 灬 
𡇼	囗 曷 
𡇿	囗 剌 
𡈀	囗 亞 
𡈅	固 介 
𡈆	囗 咢 
𡈉	囗 若 
𡈊	囗 馬 
𡈋	𰀉 𡆵 
𡈍	田 𠈌 
𡈎	囗 烏 
𡈏	囗 氣 
𡈐	囗 荅 
𡈒	囗 死 心 
𡈓	囗 真 
𡈗	囗 莫 
𡈙	囗 鳥 
𡈞	囗 𡗜 圭 
𡈠	囗 章 
𡈣	囗 𡬳 
𡈦	囗 堯 
𡈧	𠮛 囗 亞 
𡈮	囗 蓋 
𡈰	囗 語 
𡈴	囗 縣 
𡈵	囗 環 
𡈼	丿 土 
𡈿	土 十 
𡉂	力 土 
𡉄	𠂇 土 
𡉆	土 凵 
𡉇	土 人 
𡉉	土 𠔼 
𡉎	土 工 
𡉐	工 土 
𡉑	土 大 
𡉓	土 女 
𡉗	土 子 
𡉚	㞢 土 
𡉛	土 气 
𡉡	土 厶 人 
𡉦	土 午 
𡉩	土 犬 
𡉪	土 牙 
𡉫	屯 土 
𡉭	土 日 
𡉴	土 戶 
𡉷	巴 土 
𡉸	𠙸 土 
𡉺	土 水 
𡊁	土 卬 
𡊅	弁 土 
𡊉	土 末 
𡊍	土 术 
𡊛	土 去 
𡊝	瓦 土 
𡊞	平 土 
𡊟	土 目 
𡊠	土 甲 
𡊡	土 由 
𡊣	丘 土 
𡊥	丿 ⺃ 𪢴 
𡊧	土 卯 
𡊨	土 玄 
𡊫	土 宂 
𡊭	必 土 
𡊶	土 印 
𡊸	土 戎 
𡊻	土 列 
𡊼	巩 土 
𡋙	土 回 
𡋚	件 土 
𡋟	土 交 
𡋩	彳 士 土 
𡋪	⺊ 𠕀 土 
𡋭	北 冖 土 
𡋯	土 孛 
𡋲	丣 土 
𡌔	土 肖 
𡌚	土 坐 
𡌜	土 𠆢 出 
𡌞	土 尸 𠃌 土 
𡌣	土 ⺫ 七 
𡌤	圭 犬 
𡌦	非 土 
𡌩	土 沓 
𡌪	多 圣 
𡌭	叕 土 
𡌲	圭 句 
𡌴	直 土 
𡍌	土 戔 
𡍍	土 止 止 
𡍐	土 囗 外 
𡍒	土 匋 
𡍡	土 土 夗 
𡍥	土 柴 
𡍦	土 軍 
𡍨	土 度 
𡍪	土 臿 
𡍫	土 則 
𡍮	丿 土 𠈌 
𡍲	土 耷 
𡍶	𦤶 土 
𡍷	土 恒 
𡍻	土 瓮 
𡎁	胡 土 
𡎉	者 土 
𡎊	范 土 
𡎍	土 𧆞 
𡎐	坴 丮 
𡎑	土 彥 
𡎒	活 土 
𡎔	土 屋 
𡎘	土 英 
𡎫	土 𠚏 
𡎬	坐 且 
𡎮	土 屑 
𡎳	弱 土 
𡎺	祝 土 
𡎻	土 座 
𡎾	土 勹 朋 
𡎿	立 尼 土 
𡏀	土 𡌥 
𡏁	土 迴 
𡏖	土 盍 
𡏘	土 夏 
𡏚	土 虒 
𡏛	土 奚 
𡏞	土 冓 
𡏩	𠂤 坐 
𡏪	土 爫 又 木 
𡏭	土 梟 
𡏮	土 巢 
𡏯	土 敗 
𡏲	土 既 
𡏵	而 瓦 土 
𡏼	土 敖 
𡐋	土 曹 
𡐌	土 逐 
𡐒	土 毫 
𡐔	土 寅 
𡐖	土 堅 
𡐞	敝 土 
𡐠	盾 圭 
𡐤	土 絜 
𡐥	土 天 非 
𡐿	土 逹 
𡑀	棥 土 
𡑄	土 掌 
𡑆	土 量 
𡑈	垂 𠂤 
𡑍	土 勞 
𡑎	土 尋 
𡑘	氏 侖 土 
𡑚	士 冖 示 圣 
𡑞	土 遂 
𡑟	土 過 
𡑢	土 葉 
𡑣	土 窟 
𡑤	𣎆 土 
𡑯	土 僉 
𡑶	將 𠆢 土 
𡑻	𣔾 土 
𡑽	土 𠁊 
𡑾	土 虞 
𡒁	土 䪞 
𡒃	奧 土 
𡒊	與 土 
𡒌	土 遣 
𡒍	聚 土 
𡒏	土 巛 龱 丿 氺 ⺃ 
𡒒	名 土 勿 中 
𡒖	溉 土 
𡒢	皷 土 
𡒧	土 𭥭 斤 
𡒯	土 蒙 
𡒱	敵 土 
𡒳	土 臱 
𡒾	土 𭟼 
𡓉	飠 有 土 
𡓍	土 巤 
𡓓	𦥑 𠆢 𦥑 土 
𡓔	土 廩 
𡓖	堯 成 
𡓘	土 霍 
𡓜	土 廧 
𡓣	土 𩫏 
𡓦	土 毚 
𡓭	彌 土 
𡓰	土 虧 
𡓷	䭉 土 
𡓿	𠱠 𠱠 土 
𡔇	類 土 
𡔕	贑 土 
𡔛	刀 士 
𡔜	士 尸 
𡔞	亡 壬 
𡔢	夨 吉 
𡔣	士 吳 
𡔪	士 冖 口 土 
𡔱	士 冖 由 大 
𡔴	士 冖 公 ⺝ 
𡕁	士 兢 
𡕄	士 冖 ⺆ 𰀆 𠮷 
𡕉	吉 冖 癶 𠙼 
𡕏	壺 桑 
𡕐	壽 周 
𡕖	夂 𰀁 
𡕗	夂 丯 
𡕢	一 火 夊 
𡕥	目 夊 
𡕧	亢 夋 
𡕨	亠 口 口 夊 
𡕪	𠃬 夊 
𡕮	去 夌 
𡕰	𠚍 八 夂 
𡖉	夕 卪 
𡖊	夕 丮 
𡖌	夕 中 
𡖎	多 力 
𡖐	多 也 
𡖑	多 勺 
𡖒	多 勻 
𡖓	多 冘 
𡖔	多 冄 
𡖛	夕 冏 
𡖝	多 冉 
𡖞	多 占 
𡖢	多 宂 
𡖣	多 囙 
𡖤	多 台 
𡖧	多 至 
𡖪	多 在 
𡖫	多 舟 
𡖬	多 先 
𡖯	多 束 
𡖲	多 妥 
𡖳	夾 多 
𡖶	莫 夕 
𡖺	名 夜 
𡖻	多 直 
𡖾	多 其 
𡗁	多 侯 
𡗆	婁 多 
𡗈	多 㽞 
𡗍	養 多 
𡗏	嚴 多 
𡗑	㗬 襄 
𡗔	大 丨 
𡗗	三 人 ? 
𡗞	幺 大 
𡗢	大 㐄 
𡗥	大 屯 
𡗦	大 介 
𡗲	大 斤 
𡗳	公 大 
𡗵	大 引 
𡗷	大 瓜 
𡗸	大 乍 
𡗹	大 弁 
𡗼	大 此 
𡘍	大 亘 
𡘏	大 好 
𡘐	大 亠 日 
𡘛	大 奻 
𡘝	大 束 
𡘡	𦣞 大 
𡘧	大 步 
𡘪	大 身 
𡘭	折 大 
𡘰	大 豆 
𡘴	大 㡀 
𡙀	㡀 夨 
𡙋	大 目 夂 
𡙑	亠 日 尖 
𡙓	大 彥 
𡙘	大 𢇂 
𡙛	兹 大 
𡙣	大 夏 
𡙬	大 售 
𡙭	規 大 
𡙳	㚔 勹 手 
𡙶	夭 竜 
𡚁	敝 大 
𡚈	普 天 
𡚊	大 𨾴 
𡚍	大 品 止 
𡚑	天 道 
𡚔	大 䀠 灬 
𡚗	大 畾 
𡚙	𭘧 旲 
𡚛	大 㕛 臣 㕛 土 
𡚜	大 雚 
𡚟	大 難 
𡚠	大 矍 
𡚦	女 丶 
𡚨	女 𠤎 
𡚭	女 八 
𡚮	久 女 
𡚷	勺 女 
𡚸	女 么 
𡚹	女 丈 
𡚻	女 大 
𡚼	女 氏 
𡚽	丑 女 
𡚾	女 殳 
𡛌	天 女 
𡛗	比 女 
𡛘	女 匹 
𡛙	女 幼 
𡛜	女 氐 
𡛝	歺 女 
𡛞	女 弁 
𡛟	女 戉 
𡛠	女 去 
𡛡	女 皮 
𡛵	正 女 
𡛶	女 世 
𡛽	由 女 
𡜁	女 瓜 
𡜂	污 女 
𡜃	女 𠕎 
𡜉	女 杂 
𡜊	女 缶 
𡜋	女 巟 
𡜚	女 而 
𡜝	同 女 
𡜢	女 尸 尸 
𡜥	女 𠂤 
𡜦	𠦄 女 
𡜧	女 囟 
𡜨	女 休 
𡜪	女 巛 山 
𡜫	女 厶 丹 
𡜬	女 伊 
𡜯	女 𦔮 
𡜱	女 忌 
𡜲	女 告 
𡜳	女 酉 
𡜵	女 甫 
𡜿	女 亩 
𡝈	奻 夫 
𡝉	夫 奻 
𡝊	女 折 
𡝋	奻 木 
𡝍	女 豕 
𡝏	女 𡧍 
𡝐	女 余 
𡝒	女 𢗡 
𡝓	㚣 𭅄 
𡝗	女 君 
𡝙	女 佘 
𡝚	女 呈 
𡝛	女 又 𠙻 
𡝜	女 𠂆 古 
𡝝	汪 女 
𡝟	女 秊 
𡝠	弥 女 
𡝦	女 乳 
𡝧	制 女 
𡝩	女 芺 
𡝫	沾 女 
𡞏	女 奈 
𡞘	女 妾 
𡞙	女 盲 
𡞚	女 肯 
𡞜	酋 女 
𡞞	女 省 
𡞟	叛 女 
𡞠	活 女 
𡞢	女 剋 
𡞣	咸 女 
𡞥	女 矦 
𡞦	女 㝁 
𡞪	女 复 
𡞫	女 柰 
𡞭	女 帠 
𡞯	女 苦 
𡞾	女 耍 
𡟍	女 革 
𡟑	女 侯 
𡟓	女 哀 
𡟕	施 女 
𡟞	女 修 
𡟟	女 怱 
𡟠	女 𥄉 
𡟢	女 𠚏 
𡟣	女 𧆞 
𡟤	女 口 𠃊 目 
𡟥	女 禹 
𡟨	陝 女 
𡟩	女 屑 
𡟫	女 貢 
𡟭	女 屖 
𡟯	女 恩 
𡟰	女 冤 
𡟳	女 𠁁 
𡠆	𣪊 女 
𡠉	牙 攵 厂 女 
𡠊	女 條 
𡠋	師 女 
𡠏	女 桑 
𡠒	女 𢇅 
𡠖	女 臯 
𡠗	執 女 
𡠘	女 卝 土 永 
𡠙	女 通 
𡠚	女 畢 
𡠜	莫 女 
𡠞	女 符 
𡠥	强 女 
𡠹	女 帶 
𡠼	敕 女 
𡠿	女 梟 
𡡀	女 眷 
𡡂	女 羕 
𡡈	女 崩 
𡡉	麻 女 
𡡊	女 巢 
𡡏	稍 女 
𡡐	女 菐 
𡡑	女 曾 
𡡒	女 斯 
𡡓	須 女 
𡡔	女 最 
𡡕	厥 女 
𡡖	女 朁 
𡡥	女 渠 
𡡺	女 淼 
𡢀	女 巽 
𡢈	湯 女 
𡢊	女 ⺫ 旲 
𡢎	免 生 女 
𡢒	女 竹 豆 
𡢕	毀 女 
𡢖	𣪠 女 
𡢘	女 黽 
𡢚	女 㬅 
𡢜	广 祢 女 
𡢱	女 剽 
𡢳	女 感 
𡢹	姦 男 
𡣀	⻖ 𢈙 女 
𡣁	女 孴 
𡣂	𠘂 女 
𡣈	女 署 
𡣋	女 𡬽 
𡣔	妗 圅 
𡣕	女 賔 
𡣠	𤲶 女 
𡣢	重 委 
𡣪	女 適 
𡣬	女 ⺫ 厂 ⺫ 大 
𡣮	女 蔡 
𡣯	女 𢧵 
𡣹	言 炏 女 
𡣽	女 閻 
𡣾	女 蕭 
𡤋	女 韰 
𡤌	女 歷 
𡤎	女 毚 
𡤗	女 蜀 火 
𡤙	女 聶 
𡤛	女 轉 
𡤞	女 龜 
𡤢	女 羅 
𡤫	齒 可 女 
𡤶	女 彎 
𡤽	子 一 
𡤿	子 人 
𡥁	子 刂 
𡥆	丑 子 
𡥈	爻 子 
𡥍	㕛 子 
𡥎	此 子 
𡥘	母 子 
𡥨	孖 日 
𡥩	子 弟 
𡥶	子 禹 
𡥸	尾 孕 
𡥽	未 攵 子 
𡥿	子 重 
𡦁	彖 子 
𡦃	𤇾 子 
𡦄	多 孚 
𡦆	卑 孕 
𡦊	孝 子 子 
𡦍	子 斊 
𡦎	子 氣 
𡦔	帝 孕 
𡦕	子 專 
𡦛	我 享 
𡦜	子 童 
𡦝	周 孝 
𡦟	享 卑 
𡦨	享 虎 
𡦳	孝 𢊁 
𡦷	孑 孑 子 日 孑 孑 子 
𡦻	宀 㔾 
𡦼	宀 人 
𡧍	宀 丏 
𡧒	宀 歹 
𡧔	宀 殳 
𡧕	宀 㕛 
𡧖	宀 ㇇ 木 
𡧗	宀 瓦 
𡧙	宀 卯 
𡧣	宀 右 
𡧥	宀 中 𠃌 
𡧦	宀 矢 
𡧨	宀 出 
𡧩	宀 圭 
𡧭	宀 危 
𡧮	宀 㫐 
𡧯	宀 尗 
𡧱	宀 𢀛 
𡧹	宙 一 
𡧼	穴 日 
𡧽	宀 巟 
𡨀	宀 余 
𡨂	宀 吾 
𡨄	宀 𠀎 八 
𡨅	宀 局 
𡨇	宀 皀 
𡨖	宀 利 
𡨗	宀 皂 
𡨛	宀 夆 
𡨜	宀 𠦑 
𡨢	宀 居 
𡨣	宀 𤘴 
𡨧	宀 卒 
𡨩	宀 昏 
𡨲	宀 表 
𡨳	宀 老 人 
𡨵	宀 大 旦 
𡨻	宀 乳 
𡨽	宀 省 
𡨿	宀 𰃦 㐅 火 
𡩂	宀 一 血 八 
𡩃	宀 恆 
𡩄	宀 勉 
𡩆	束 它 
𡩇	宀 目 𠃊 𫶧 
𡩘	宀 音 
𡩚	宀 彐 𧰨 
𡩡	宀 索 
𡩣	宀 桀 
𡩤	宀 借 
𡩥	宀 翁 
𡩩	𪧇 吂 
𡩶	宜 央 
𡩸	宀 禾 号 
𡩽	𪧇 尨 
𡩾	宀 區 
𡪁	𪧇 含 
𡪅	宀 郰 
𡪐	宀 㚔 丸 
𡪑	宀 品 丂 
𡪒	宀 𰏒 田 
𡪗	𪧇 一 合 
𡪙	安 明 
𡪞	客 𠮢 
𡪠	宀 曾 
𡪰	宀 䎜 
𡪱	宀 猋 
𡪳	𭓦 見 
𡪵	宀 鈙 
𡪹	宀 𮊿 
𡪺	宀 登 
𡫀	宀 敫 
𡫁	宀 𧠪 
𡫂	宀 絹 
𡫃	𫲽 ⺫ 天 
𡫛	宀 自 㓁 𠔽 
𡫟	宀 㠭 大 
𡫥	客 客 
𡫦	宛 辱 
𡫧	𪧇 一 彐 冖 目 
𡫬	宀 𥱩 
𡫯	宀 歷 
𡫳	宀 㠭 廾 
𡫵	宀 衣 ⺫ 禾 
𡫸	寧 吉 
𡫹	宓 屮 咸 
𡫺	𪧇 𦴋 
𡫽	𪧇 ⻀ ⺫ 冖 女 
𡬁	宀 𦓈 
𡬂	富 則 
𡬄	𪧇 𦭝 冖 水 
𡬆	宀 懵 
𡬇	𪧇 𦭝 冖 不 
𡬉	盾 塞 
𡬊	𪧇 𦭝 冖 夭 
𡬌	𪧇 瞢 
𡬍	𪧇 𦭝 冖 米 
𡬎	宀 羌 羌 羌 
𡬓	𪧇 𦭝 冖 𠬶 
𡬕	𫲽 𦓈 
𡬖	𪧇 𦭝 冖 炎 
𡬗	寧 壹 
𡬘	翏 寬 
𡬙	𪧇 𦭝 冖 則 
𡬞	⺄ ⺄ ⺄ 寸 
𡬫	舟 寸 
𡬯	𦥔 寸 
𡬲	巛 目 寸 
𡬳	爫 寸 ⺫ 
𡬵	垔 寸 
𡬸	巛 𦥑 寸 
𡭂	束 㝵 
𡭇	專 内 
𡭋	㐁 辱 
𡭐	巵 專 
𡭘	乃 小 
𡭚	三 小 
𡭛	小 廾 
𡭞	小 火 
𡭢	小 木 
𡭣	小 少 
𡭥	勿 少 
𡭭	小 吏 
𡭮	小 有 
𡭴	小 小 日 
𡭷	小 豕 
𡭸	少 同 
𡭾	小 乳 
𡭿	尚 之 
𡮎	亢 京 
𡮙	能 小 
𡮚	小 厶 周 
𡮞	害 少 
𡮦	曹 少 
𡮰	广 秝 小 
𡮻	監 少 
𡮿	毚 少 
𡯄	尢 力 
𡯇	尢 刂 
𡯈	尢 人 
𡯉	尢 又 
𡯋	尢 干 
𡯏	尢 斗 
𡯐	尢 木 
𡯑	尣 水 
𡯒	尣 日 
𡯘	尢 反 
𡯙	尢 日 
𡯛	尣 左 
𡯢	尢 ⾆ 
𡯣	尢 艮 
𡯥	尢 虫 
𡯨	尢 坐 
𡯩	尢 肖 
𡯫	尣 㒵 
𡯰	尢 戒 
𡯱	尣 皀 
𡯳	尢 咅 
𡯴	尢 卓 
𡯵	尢 委 
𡯷	尣 咅 
𡯽	尢 咸 
𡯿	尢 負 
𡰀	尢 拏 
𡰂	尣 畏 
𡰅	兀 骨 
𡰆	尢 臬 
𡰋	尢 崔 
𡰌	尢 婁 
𡰎	尢 鳥 
𡰐	虛 尤 
𡰑	尢 喬 
𡰒	尢 童 
𡰖	尢 爫 是 
𡰚	粦 尤 
𡰝	尢 雚 
𡰞	兀 雚 
𡰠	尢 羸 
𡰢	尢 爫 巂 
𡰣	コ 丿 
𡰥	尸 二 
𡰨	尸 丁 
𡰪	尸 口 
𡰫	尸 叉 
𡰯	尸 巾 
𡰵	尸 攴 
𡰸	尸 支 
𡰹	尸 丿 𣥂 
𡰽	尸 尤 
𡰾	尸 𠂔 
𡰿	尸 八 夊 
𡱁	尸 矢 
𡱂	尸 兀 几 
𡱅	尸 去 
𡱆	尸 丙 
𡱇	尸 占 
𡱊	尸 𠃌 水 
𡱌	尸 亘 
𡱐	尸 夷 
𡱑	尸 䏍 
𡱔	尸 二 日 
𡱜	尸 兆 
𡱣	尸 彳 予 
𡱯	尸 弄 
𡱱	尸 彳 夭 
𡱳	尸 沙 
𡱷	尸 𦔮 
𡱺	尸 彳 句 
𡱼	尸 果 
𡱽	尸 忽 
𡱾	尸 取 
𡲀	尸 空 
𡲆	尸 爿 支 
𡲍	尸 口 幼 
𡲕	尸 彳 曳 
𡲗	尸 犬 出 
𡲚	尸 酋 
𡲣	尸 降 
𡲪	尾 孕 
𡲭	尾 曳 
𡲮	尸 𣬉 
𡲰	尸 徐 
𡲼	尾 亥 
𡲾	尸 𢓰 
𡲿	尸 爿 曳 
𡳂	尸 豈 
𡳄	尸 啚 
𡳆	尸 虘 
𡳏	尸 兆 句 
𡳑	尸 𡍮 
𡳚	尸 𠃌 國 
𡳞	尸 粦 
𡳭	尼 木 桑 
𡳮	尸 積 
𡳴	𣎆 廿 尸 
𡳸	尸 彳 歷 
𡴅	屮 巾 
𡴆	屮 六 
𡴎	屮 𠂤 
𡴔	屮 太 龴 
𡴘	夭 屰 
𡴞	屮 夲 允 
𡴭	山 乙 
𡴯	山 乙 
𡴱	山 㔾 
𡴹	山 卩 
𡵀	山 亡 
𡵉	山 兀 
𡵒	巳 山 
𡵓	山 厷 
𡵕	丹 山 
𡵖	山 火 
𡵘	山 戶 
𡵙	山 卬 
𡵚	山 介 
𡵛	山 父 
𡵜	山 牛 
𡵞	山 丰 
𡵬	山 木 
𡵭	屯 山 
𡵶	勿 山 
𡵷	山 𠘬 
𡵻	山 亢 
𡶂	屵 二 
𡶃	山 戹 
𡶄	山 包 
𡶆	山 叵 
𡶈	山 史 
𡶉	山 乏 
𡶋	山 尻 
𡶌	山 石 
𡶎	山 未 
𡶏	山 出 
𡶐	山 加 
𡶑	山 甘 
𡶢	山 兄 
𡶣	山 八 夊 
𡶤	山 用 
𡶥	山 加 
𡶦	山 丘 
𡶪	石 山 
𡶫	山 𠂤 
𡶭	山 刑 
𡶯	山 囟 
𡶱	山 𠫤 
𡶲	山 朶 
𡶴	山 产 
𡶾	山 百 
𡷋	山 公 儿 
𡷍	山 江 
𡷎	山 宇 
𡷏	山 聿 
𡷐	山 艮 
𡷓	山 大 廾 
𡷕	山 尾 
𡷖	山 車 
𡷗	山 完 
𡷘	山 別 
𡷛	山 旱 
𡷜	屵 主 
𡷝	山 𦔮 
𡷞	山 忌 
𡷠	山 投 
𡷡	山 肙 
𡷢	山 忘 
𡷤	山 吳 
𡷥	告 山 
𡷨	山 巠 
𡷪	屾 天 
𡷫	山 成 
𡷸	山 孝 
𡷺	艹 小 山 
𡷻	山 木 山 
𡷼	山 木 山 
𡷽	山 束 
𡷿	山 足 
𡸂	山 余 
𡸃	山 佥 
𡸅	山 𢎿 
𡸈	山 𣅋 
𡸉	山 利 
𡸌	山 住 
𡸎	山 即 
𡸑	山 易 
𡸔	山 ⺇ 圭 
𡸕	山 穹 
𡸗	山 軋 
𡸘	山 取 
𡸛	山 欦 
𡸜	山 直 
𡸞	山 臽 
𡸟	山 甾 
𡸡	厂 吅 山 
𡸣	山 兒 
𡸤	山 戕 
𡸥	山 宛 
𡸦	山 𣅳 
𡸨	山 取 
𡸪	山 事 
𡸫	山 并 
𡹄	山 亞 
𡹇	山 林 
𡹉	山 歧 
𡹎	山 𡇌 
𡹓	山 念 
𡹔	山 朋 
𡹕	山 亠 兇 
𡹖	山 炏 
𡹙	山 帚 
𡹢	山 近 
𡹣	山 阿 
𡹥	山 卯 土 
𡹨	山 日 冖 又 
𡹩	臤 山 
𡹪	山 亟 
𡹬	山 咼 
𡹭	山 室 
𡹯	山 廻 
𡹰	山 茅 
𡹲	山 胥 
𡹵	山 侯 
𡹶	山 匽 
𡹷	山 降 
𡹸	山 怱 
𡹹	胡 山 
𡹼	屵 言 
𡹾	山 昺 
𡺇	山 𨹅 
𡺐	山 者 
𡺑	山 枼 
𡺓	山 皆 
𡺔	是 山 
𡺕	山 貝 力 
𡺖	山 幽 
𡺗	山 看 
𡺘	山 秋 
𡺛	山 仌 丨 仌 
𡺜	山 分 瓦 
𡺞	山 音 
𡺟	山 宣 
𡺡	山 盈 
𡺧	刍 攵 山 
𡺫	山 舀 
𡺭	山 貢 
𡺮	屵 肥 
𡺯	山 䍃 
𡺲	山 陖 
𡺴	山 窋 
𡺵	山 豺 
𡺷	山 夏 
𡺸	山 耆 
𡺺	山 躬 
𡺽	山 晉 
𡻈	山 秦 
𡻌	山 𡷰 
𡻎	崔 乃 
𡻐	山 翁 
𡻑	山 冢 
𡻒	務 山 
𡻕	山 戚 
𡻘	山 盖 
𡻙	山 郭 
𡻚	山 康 
𡻝	山 巢 
𡻞	山 畢 
𡻟	山 莫 
𡻠	山 庶 
𡻡	山 酓 
𡻢	山 圉 
𡻣	山 移 
𡻤	麻 山 
𡻧	豉 山 
𡻨	山 袞 
𡻩	山 曼 
𡻪	山 翏 
𡻫	山 亠 品 
𡻬	山 族 
𡻭	山 累 
𡻮	山 扈 
𡻯	山 爽 
𡻰	山 祭 
𡻱	山 累 
𡼁	山 离 
𡼃	山 婆 
𡼄	山 窒 
𡼊	山 絫 
𡼎	山 喜 
𡼐	昏 攵 山 
𡼓	山 奠 
𡼖	敦 山 
𡼗	山 自 𠦂 
𡼘	𡷈 𠇏 
𡼚	㗊 山 
𡼜	山 㻚 
𡼬	山 覃 
𡼱	山 圍 
𡼻	𡸁 𠂤 
𡼼	山 朝 
𡼽	山 飲 
𡼾	山 會 
𡼿	山 窟 
𡽁	山 辠 
𡽂	山 鼓 
𡽃	隓 山 
𡽅	山 運 
𡽆	山 寘 
𡽉	山 齊 
𡽊	山 當 
𡽕	山 辠 
𡽖	山 解 
𡽛	山 碓 
𡽜	山 利 言 
𡽝	山 蒿 
𡽠	山 頗 
𡽢	山 翟 
𡽣	山 厭 
𡽧	屵 堯 
𡽱	山 截 
𡽲	山 榜 
𡽳	山 監 
𡽴	山 臧 
𡽶	山 鼻 
𡽻	山 漸 
𡾅	山 慮 
𡾇	山 廣 
𡾉	山 摩 
𡾋	山 畾 
𡾌	山 麃 
𡾒	山 樂 
𡾓	山 層 
𡾕	屾 湯 
𡾖	山 磈 
𡾙	山 噩 
𡾛	山 鬼 并 
𡾜	山 霍 
𡾝	山 褱 
𡾥	山 縣 
𡾦	山 山 𠂤 辛 
𡾨	山 褱 
𡾮	山 鮮 
𡾰	山 蹇 
𡾱	山 彌 
𡾲	山 薛 
𡾻	山 臧 
𡾼	山 雙 
𡾽	山 繒 
𡾾	山 𨪈 
𡿂	崇 巛 里 
𡿄	山 藏 
𡿉	藟 山 
𡿊	難 山 
𡿋	山 蠆 
𡿎	山 離 
𡿏	山 羅 
𡿓	山 黨 
𡿖	山 齧 
𡿗	山 蘖 
𡿙	山 鷄 
𡿛	屵 𰘾 
𡿝	山 囊 
𡿠	山 鱗 
𡿡	山 靈 
𡿤	卝 八 日 八 土 山 口 山 口 
𡿥	山 鬱 
𡿧	巛 一 
𡿩	巛 𠔼 
𡿪	巛 夕 
𡿯	曰 巛 
𡿺	巛 囟 
𡿼	巛 𦉴 
𡿾	巛 隹 
𡿿	或 巛 
𢀁	巛 反 犮 
𢀊	巢 虍 人 
𢀋	巢 𧆞 
𢀍	景 邕 
𢀓	工 ? 
𢀕	工 𠃌 
𢀗	工 亅 ⺃ 
𢀙	工 丩 
𢀜	工 丮 
𢀪	工 𮦆 
𢀵	己 己 
𢀼	共 巴 
𢁀	共 包 
𢁁	豖 巳 
𢁂	其 巳 
𢁏	告 血 己 
𢁒	巾 几 
𢁓	丆 巾 
𢁕	巾 勺 
𢁖	巾 大 
𢁗	巾 干 
𢁘	巾 彡 
𢁞	巾 𠚣 
𢁠	巾 弓 
𢁢	巾 亐 
𢁤	巾 𱍸 
𢁥	分 巾 
𢁧	巾 欠 
𢁩	巾 內 
𢁪	巾 夬 
𢁬	巾 爪 
𢁮	巾 今 
𢁱	巾 夭 
𢁶	巾 𠕀 
𢁷	巾 公 
𢁹	𠀉 巾 
𢁻	巾 布 
𢁼	巾 宁 
𢁽	巾 必 
𢁾	巾 召 
𢁿	巾 正 
𢂀	巾 弗 
𢂁	巾 句 
𢂃	巾 乍 
𢂄	巾 玄 
𢂆	巾 付 
𢂊	巾 幼 
𢂍	巾 𠂔 
𢂐	巾 劦 
𢂑	巾 式 
𢂒	巾 夷 
𢂔	巾 共 
𢂕	巾 危 
𢂗	印 巾 
𢂘	巾 全 
𢂝	巾 曳 
𢂤	市 犮 
𢂨	凢 凢 巾 
𢂱	巾 肙 
𢂶	巾 冏 
𢂷	巿 合 
𢂹	巾 皃 
𢂺	𣦼 巾 
𢂼	折 巾 
𢃀	巾 巫 
𢃍	巾 卑 
𢃎	巾 或 
𢃏	巾 宗 
𢃐	巾 空 
𢃕	巾 沓 
𢃗	巾 函 
𢃘	𢼄 巾 
𢃛	其 巾 
𢃜	巾 直 
𢃢	巾 青 
𢃥	臤 巾 
𢃦	巾 果 
𢃩	巾 卷 
𢃬	前 巾 
𢃭	巾 怱 
𢃮	巾 面 
𢃯	巾 癸 
𢃰	巾 是 
𢃱	巾 某 
𢃲	巾 革 
𢃳	帚 巴 
𢃴	剌 巾 
𢃸	巾 秋 
𢃺	帛 及 
𢄄	㞢 巾 且 
𢄅	巾 戈 一 火 
𢄇	帛 勾 
𢄊	巾 鬼 
𢄋	𤇾 巾 
𢄌	巾 殺 
𢄍	巾 盍 
𢄎	巾 旁 
𢄏	𡨄 巾 
𢄐	巾 冡 
𢄓	巾 烏 
𢄔	𠂉 帶 
𢄗	帛 冋 
𢄜	巾 圅 
𢄟	巾 通 
𢄠	巾 區 
𢄡	𠩺 巾 
𢄢	埶 巾 
𢄣	巾 彗 
𢄤	斬 巾 
𢄥	⺕ ⺈ 巾 帇 
𢄦	巾 鳥 
𢄧	族 巾 
𢄱	巾 連 
𢄳	巾 奢 
𢄵	巾 象 
𢄶	巾 畫 
𢄷	巾 尞 
𢄸	巾 最 
𢄹	巾 喬 
𢄺	巾 焦 
𢄼	須 巾 
𢄽	巾 貳 
𢅀	巾 覃 
𢅁	孚 帛 
𢅉	帛 皃 
𢅊	無 巾 
𢅋	巾 曾 
𢅎	巾 敫 
𢅏	巾 廉 
𢅑	巾 煞 
𢅒	巾 亶 
𢅕	巾 遂 
𢅖	巾 亷 
𢅗	巾 過 
𢅚	巾 剽 
𢅜	帚 帚 
𢅝	殿 巾 
𢅞	帛 彔 
𢅟	巾 疑 
𢅠	厭 巾 
𢅡	巾 監 
𢅤	巾 蓋 
𢅥	巾 㕑 
𢅩	巾 罷 
𢅪	巾 慼 
𢅫	巾 慧 
𢅭	巾 賴 
𢅮	燅 巾 
𢅯	巾 奮 
𢅰	巾 䦧 
𢅹	巾 龠 
𢅺	書 席 
𢅼	巾 夒 
𢅾	巾 羅 
𢆀	巾 圓 全 
𢆂	巾 𦚏 㓱 
𢆉	丷 干 
𢆍	千 甲 
𢆜	曷 干 
𢆞	幵 束 
𢆟	由 幷 
𢆣	并 夜 
𢆦	䍐 東 
𢆩	久 巨 幷 
𢆯	幺 丨 
𢆰	一 幺 
𢆴	幺 𠄏 
𢆶	幺 幺 
𢆷	幺 少 
𢆸	𠃊 𢆶 
𢆺	一 𠃔 幺 
𢆻	𢆶 几 
𢆽	𢆯 少 
𢇅	𢆶 卝 
𢇇	𢆶 丱 
𢇕	幽 幽 
𢇗	广 下 
𢇘	广 女 
𢇙	广 弋 
𢇚	广 也 
𢇛	广 干 
𢇞	广 口 
𢇟	广 兀 
𢇤	广 水 
𢇥	广 卆 
𢇦	广 壬 
𢇧	广 冘 
𢇨	广 𢆰 
𢇪	广 反 
𢇫	广 乏 
𢇰	广 允 
𢇲	广 禾 
𢇳	广 皮 
𢇴	广 布 
𢇵	广 㘝 
𢇶	广 田 
𢇷	广 犮 
𢇸	广 世 
𢈂	广 㠯 
𢈆	广 召 
𢈇	广 先 
𢈈	广 合 
𢈉	广 同 
𢈋	广 䏍 
𢈓	广 有 
𢈕	广 𠂢 
𢈙	广 夾 
𢈚	广 呂 
𢈛	广 困 
𢈜	广 壯 
𢈝	广 求 
𢈠	广 束 
𢈡	广 夋 
𢈢	广 串 
𢈤	广 七 甲 
𢈯	广 身 
𢈲	广 㫗 
𢈴	广 京 
𢈵	广 空 
𢈶	广 虎 
𢈸	广 念 
𢈹	广 阜 
𢈻	广 疌 
𢈼	广 卒 
𢈽	广 戔 
𢈾	广 取 
𢉁	广 朋 
𢉂	广 官 
𢉃	广 舍 
𢉅	广 金 
𢉆	广 建 
𢉑	广 青 
𢉓	广 𦈢 ⺃ 
𢉕	广 兔 
𢉗	广 亟 
𢉘	广 炎 
𢉚	广 乳 
𢉜	广 者 
𢉝	广 畏 
𢉞	广 扁 
𢉢	广 胡 
𢉤	广 架 
𢉥	广 曷 
𢉦	广 軍 
𢉧	广 苜 
𢉨	广 剌 
𢉩	广 音 
𢉭	广 㒸 
𢉵	广 𡷈 
𢉿	广 馬 
𢊀	广 虒 
𢊄	广 隻 
𢊅	广 追 
𢊆	广 秝 
𢊍	广 𭔰 
𢊏	广 挈 
𢊒	广 烋 
𢊓	广 小 小 日 
𢊖	广 深 
𢊗	广 莫 
𢊘	广 殹 
𢊙	庣 句 
𢊚	广 徙 
𢊛	广 崔 
𢊜	广 張 
𢊧	广 魚 
𢊩	广 厶 ⺫ 比 
𢊮	广 貴 
𢊯	广 爲 
𢊱	广 賁 
𢊲	广 森 
𢊺	广 丣 田 
𢊻	广 臾 小 
𢋂	广 暑 
𢋃	广 亶 
𢋄	广 雋 
𢋅	广 歈 
𢋆	广 歆 
𢋇	广 睪 
𢋈	广 稣 
𢋒	广 蒦 
𢋔	广 奩 
𢋚	麻 肎 
𢋝	廆 木 
𢋡	广 魯 
𢋣	广 憂 
𢋮	广 𢿱 
𢋹	广 止 止 林 
𢋻	广 斂 
𢋼	广 戲 
𢋿	广 齋 
𢌀	广 褺 
𢌄	广 瞿 
𢌈	广 離 
𢌍	广 兼 兼 
𢌔	广 靈 
𢌕	广 䜌 丱 
𢌚	廴 山 
𢌛	廴 正 
𢌦	廴 壬 攵 
𢌨	廴 止 目 
𢌲	山 廾 
𢌳	𱼀 廾 
𢌷	内 廾 
𢌹	厸 廾 
𢍁	由 廾 
𢍆	㓞 廾 
𢍇	圯 廾 
𢍈	死 廾 
𢍉	甶 廾 
𢍎	告 廾 
𢍏	釆 廾 
𢍑	伯 廾 
𢍓	亠 目 廾 
𢍕	卷 廾 
𢍜	酋 廾 
𢍧	⺫ 衣 廾 
𢍩	从 囗 从 廾 
𢍪	𱼀 豆 廾 
𢍫	𣐺 开 
𢍭	凹 弁 弁 
𢍰	睪 廾 
𢍱	舁 囟 
𢍼	一 弋 
𢍿	爿 弋 
𢎀	弋 ⺝ 
𢎂	弋 仌 
𢎃	弋 日 
𢎄	可 弋 
𢎆	弋 至 
𢎈	弋 一 目 
𢎉	弋 竹 
𢎋	杏 弋 
𢎌	甘 代 
𢎎	䏍 式 
𢎔	武 曷 
𢎕	齒 弋 
𢎖	瞿 弋 
𢎘	乛 ㇉ 
𢎙	𢎘 𢎘 
𢎛	弓 丶 
𢎥	弓 二 
𢎪	弓 几 
𢎭	弓 巾 
𢎯	𭠍 弓 
𢎴	弓 大 
𢎵	弗 丨 
𢎹	弓 夬 
𢎻	弓 予 
𢏃	⺈ 冖 弓 
𢏄	弓 引 
𢏅	弓 火 
𢏆	弓 古 
𢏈	弓 㠯 
𢏍	弓 ⺊ 巳 
𢏎	弓 四 
𢏕	弓 同 
𢏗	幵 弓 
𢏙	弓 羊 
𢏜	弓 多 
𢏞	弓 丞 
𢏤	弓 夋 
𢏦	弓 矣 
𢏧	弓 角 
𢏭	弓 㐬 
𢏮	弓 𣶒 
𢏯	弓 虎 
𢏰	弓 爭 
𢏳	弓 并 
𢏷	弓 屈 
𢐂	弓 是 
𢐃	弓 扁 
𢐄	弓 彖 
𢐆	弜 吕 
𢐊	弓 旁 
𢐎	弓 兼 
𢐐	弜 系 
𢐒	弓 崩 
𢐔	弓 從 
𢐖	弓 ⻀ 日 廾 
𢐚	弓 國 
𢐞	弓 曾 
𢐟	弓 喬 
𢐦	辟 弓 
𢐩	弭 䖝 
𢐫	粥 今 
𢐲	弜 番 
𢐴	弓 人 人 丨 人 人 丨 人 人 丨 
𢐿	弓 襄 
𢑆	弓 雚 
𢑇	弓 舊 
𢑈	弓 䌛 
𢑏	𠂎 彐 
𢑓	彑 儿 乂 
𢑖	⺕ 甲 
𢑝	𢑑 冘 
𢑞	彑 八 一 𠂊 巾 
𢑟	彐 冖 伐 
𢑠	𢑑 㐌 
𢑢	日 㣇 
𢑧	𢑑 束 
𢑬	𢑑 來 
𢑮	𢑑 飛 
𢑱	⺔ 粉 大 
𢑹	彗 亞 
𢒆	忄 彡 
𢒉	彡 且 
𢒍	弗 彡 
𢒐	坐 彡 
𢒒	孚 彡 
𢒔	豖 彡 
𢒝	⺇ 臣 彡 
𢒞	柬 彡 
𢒩	彡 徙 
𢒫	彡 尋 
𢒯	口 𧆞 彡 
𢒰	有 彧 
𢒱	歲 彡 
𢒲	亠 彡 徙 
𢒷	須 咅 
𢒹	广 𱤏 彡 
𢒾	彳 丩 
𢓀	彳 弋 
𢓃	彳 丸 
𢓄	彳 开 
𢓆	彳 元 
𢓇	彳 內 
𢓈	彳 勻 
𢓋	彳 卬 
𢓍	彳 天 
𢓎	彳 𢆰 
𢓒	彳 冉 
𢓔	彳 立 
𢓕	彳 占 
𢓖	彳 丕 
𢓗	彳 此 
𢓘	彳 冬 
𢓙	彳 𢎢 
𢓜	彳 各 
𢓝	彳 兆 
𢓞	彳 丞 
𢓟	彳 州 
𢓡	彳 夷 
𢓢	彳 夸 
𢓣	彳 朿 
𢓧	彳 地 
𢓬	彳 希 
𢓮	彳 肖 
𢓯	彳 狂 
𢓰	彳 妥 
𢓱	彳 夆 
𢓲	彳 吾 
𢓴	彳 日 夂 
𢓵	彳 秀 
𢓿	彳 夂 心 
𢔁	彳 夌 
𢔂	彳 奄 
𢔅	彳 東 
𢔆	彳 泣 
𢔇	彳 匋 
𢔈	彳 函 
𢔊	彳 知 
𢔋	彳 松 
𢔑	彳 卷 
𢔔	彳 亟 
𢔟	彳 柔 
𢔠	彳 目 支 
𢔡	彳 皆 
𢔢	彳 俞 
𢔣	彳 臿 
𢔤	彳 貞 
𢔥	彳 胃 
𢔧	彳 屏 
𢔪	彳 者 
𢔬	行 先 
𢔯	彳 剌 
𢔱	彳 卻 
𢔲	彳 丣 田 
𢔴	彳 郚 
𢕅	行 山 方 
𢕈	彳 耸 
𢕋	行 完 
𢕑	彳 率 
𢕓	彳 區 
𢕔	彳 章 
𢕕	彳 參 
𢕖	彳 䙴 
𢕘	彳 崔 
𢕙	彳 猛 
𢕚	彳 淂 
𢕞	彳 𥃭 心 
𢕟	彳 敖 
𢕦	彳 丨 夂 良 
𢕨	彳 白 冖 方 
𢕪	彳 喬 
𢕫	彳 款 
𢕬	彳 歰 
𢕭	彳 敢 
𢕮	彳 啻 
𢕯	彳 覃 
𢕷	彳 爲 
𢕺	彳 歲 
𢕻	彳 詹 
𢖄	彳 山 攵 虫 
𢖅	行 訔 
𢖆	彳 解 
𢖇	彳 廌 
𢖈	彳 翟 
𢖊	彳 䛣 
𢖋	行 土 田 廾 
𢖎	彳 覀 大 㠯 
𢖏	彳 賣 
𢖑	彳 賛 
𢖗	束 從 
𢖛	彳 丨 夂 黑 
𢖝	彳 韱 
𢖟	彳 繇 
𢖡	行 去 𢇂 
𢖤	彳 題 
𢖦	彳 矍 
𢖧	彳 囊 
𢖫	刀 心 
𢖬	忄 匕 
𢖲	忄 乇 
𢖳	忄 于 
𢖴	乞 心 
𢖵	忄 女 
𢖷	忄 工 
𢖺	忄 弋 
𢖻	心 夂 
𢖼	弋 心 
𢖽	土 心 
𢖿	小 心 
𢗀	口 心 
𢗂	ユ ㇉ 心 
𢗄	忄 下 
𢗈	必 丁 
𢗉	忄 內 
𢗊	介 心 
𢗎	忄 殳 
𢗝	忄 互 
𢗫	不 心 
𢗭	日 心 
𢗯	月 心 
𢗲	忄 夫 
𢗳	忄 毛 
𢗴	忄 兮 
𢗵	忄 孔 
𢗹	斤 心 
𢗺	必 亡 
𢗿	忄 末 
𢘀	忄 犮 
𢘁	𠕁 心 
𢘃	忄 母 
𢘄	忄 囚 
𢘅	矛 心 
𢘇	旦 心 
𢘉	忄 甲 
𢘊	忄 申 
𢘋	代 心 
𢘌	忄 弘 
𢘍	弗 心 
𢘝	忄 尔 
𢘟	心 可 
𢘥	忄 市 
𢘧	忄 𡰦 
𢘫	正 心 
𢘸	忄 夅 
𢘹	忄 杀 
𢘺	忄 米 
𢘽	忄 曳 
𢘿	艸 心 
𢙁	污 心 
𢙂	一 皿 心 
𢙅	合 心 
𢙇	忄 衣 
𢙉	忄 𭗼 
𢙐	忄 农 
𢙓	忄 会 
𢙠	伊 心 
𢙧	忄 丨 土 儿 
𢙮	在 心 
𢙱	忄 弄 
𢙲	忄 呂 
𢙳	忄 壯 
𢙴	㤅 夂 
𢙺	忄 志 
𢙼	忄 巠 
𢙾	忄 更 
𢙿	忄 岑 
𢚀	忄 延 
𢚁	忄 忌 
𢚂	忄 坐 
𢚄	忄 牢 
𢚅	扮 心 
𢚆	忄 助 
𢚋	忄 皃 
𢚌	忄 ⺕ 父 
𢚑	㳉 心 
𢚗	忄 宋 
𢚨	何 心 
𢚪	尸 火 心 
𢚫	𢎨 又 心 
𢚭	忄 汖 
𢚮	忄 𠂉 𠂇 三 
𢚺	忄 吞 
𢚻	忄 口 介 
𢛁	制 心 
𢛄	忄 厓 
𢛆	弦 心 
𢛉	忄 垂 
𢛍	忄 知 
𢛎	忄 㡀 
𢛒	忄 松 
𢛓	林 心 
𢛔	忄 東 
𢛕	忄 囷 
𢛖	共 㔾 心 
𢛘	忄 肴 
𢛙	忄 穹 
𢛚	辰 心 
𢛛	忄 往 
𢛜	泥 心 
𢛞	忄 卑 
𢛟	忄 亞 
𢛥	尸 思 
𢛦	𣢊 心 
𢛨	忄 於 
𢛮	牧 心 
𢛯	忄 画 
𢜗	忄 奉 
𢜘	忄 奔 
𢜣	㭊 心 
𢜥	忄 咎 
𢜨	枼 心 
𢜩	忄 咸 
𢜪	忄 若 
𢜫	忄 省 
𢜬	忄 度 
𢜭	忄 卻 
𢜮	忄 某 
𢜯	某 心 
𢜰	忄 弇 
𢜱	忄 咠 
𢜲	忄 拏 
𢜳	忄 壴 
𢜴	忄 矦 
𢜶	忄 叜 
𢜸	忄 柔 
𢜻	忄 爯 
𢜼	忄 乗 
𢜽	忄 癸 
𢜿	忄 家 
𢝀	忄 突 
𢝁	忄 訇 
𢝂	忄 毒 
𢝅	叚 心 
𢝆	忄 重 
𢝇	忄 砉 
𢝈	忄 盅 
𢝉	忄 耷 
𢝊	頁 心 
𢝌	忄 冒 
𢝍	怯 心 
𢝓	忄 泉 
𢝬	者 心 
𢝯	冂 言 心 
𢝲	秌 心 
𢝳	洪 心 
𢝴	忄 覀 心 
𢝸	忄 咼 
𢝹	忄 竹 大 
𢝻	忄 勿 目 
𢞉	洞 心 
𢞋	亻 吞 心 
𢞏	忄 宮 
𢞐	忄 害 
𢞒	殺 心 
𢞕	忄 隺 
𢞖	忄 笑 
𢞗	忄 𣬉 
𢞚	耿 心 
𢞜	忄 屑 
𢞞	忄 迷 
𢞟	忄 高 
𢞠	忄 𦐇 
𢞡	忄 冓 
𢞣	倐 心 
𢞦	忄 臼 日 
𢞬	忄 烏 
𢞭	留 心 
𢟅	修 心 
𢟊	忄 乘 
𢟋	忄 追 
𢟡	忄 ⻀ 勹 用 
𢟢	忄 离 
𢟣	忄 羕 
𢟤	𠩺 心 
𢟧	忄 鹵 
𢟨	忄 莽 
𢟩	忄 彗 
𢟪	既 心 
𢟭	忄 宀 元 攵 
𢟯	埶 心 
𢟰	忄 豙 
𢟱	忄 𣳾 
𢟳	忄 率 
𢟴	忄 㢈 
𢟵	忄 𡌦 
𢟽	莫 心 
𢟾	忄 耂 工 毛 
𢟿	忄 ⺫ 𠂢 
𢠛	教 心 
𢠝	國 心 
𢠡	忄 宀 炎 
𢠫	忄 庶 
𢠬	尸 大 𪠲 心 
𢠭	忄 寂 
𢠰	忄 從 
𢠲	忄 富 
𢠳	忄 敝 
𢠵	忄 敞 
𢠷	忄 項 
𢠹	忄 斯 
𢠺	忄 發 
𢠼	忄 買 
𢠽	忄 象 
𢠿	忄 爲 
𢡀	忄 黑 
𢡁	忄 翕 
𢡂	湯 心 
𢡃	立 患 
𢡅	忄 棐 
𢡆	豤 心 
𢡇	忄 辜 
𢡈	𠭥 心 
𢡉	忄 歰 
𢡎	忄 遇 
𢡏	忄 袲 
𢡑	㪙 心 
𢡒	忄 庚 止 
𢡰	天 明 心 
𢡵	而 恧 
𢡹	㣫 心 
𢢂	忄 結 
𢢌	敞 心 
𢢍	夂 羊 刃 心 
𢢒	忄 窣 
𢢓	忄 雍 
𢢖	忄 葛 
𢢗	忄 蜀 
𢢚	忄 歇 
𢢜	忄 業 
𢢞	𣪠 心 
𢢹	牜 香 心 
𢢼	忄 剽 
𢣉	号 官 心 
𢣊	忄 义 禾 目 
𢣎	忄 㡭 
𢣏	忄 蓋 
𢣐	忄 賓 
𢣓	㼲 心 
𢣔	忄 臱 
𢣕	疑 心 
𢣗	忄 麼 
𢣘	維 心 
𢣙	忄 𤇾 王 
𢣚	忄 爾 
𢣞	士 冖 虫 心 丸 
𢣠	月 留 心 
𢣢	思 劦 
𢣳	惢 戍 
𢣵	忄 㕑 
𢣼	忄 察 
𢣿	忄 慮 
𢤁	僺 心 
𢤂	黎 心 
𢤄	忄 蔥 
𢤆	忄 厲 
𢤋	忄 𥈜 
𢤍	𤡜 心 
𢤐	劉 心 
𢤘	蔄 心 
𢤚	忄 厸 𤰞 戈 
𢤤	憧 心 
𢤧	䫉 心 
𢤩	忄 歷 
𢤫	忄 舉 
𢤯	忄 韰 
𢤰	韰 心 
𢤱	忄 龍 
𢤲	龍 心 
𢥂	忄 駦 
𢥃	忄 諸 
𢥌	忄 鮮 
𢥐	忄 麋 
𢥘	忄 巂 
𢥚	忄 爵 
𢥛	𡫟 心 
𢥞	忄 蟲 
𢥠	忄 雙 
𢥳	忄 哥 哥 
𢥽	黑 重 心 
𢦅	忄 贛 
𢦈	忄 蠻 
𢦊	甚 甚 甚 心 
𢦌	一 戈 
𢦎	九 戈 
𢦏	戈 十 
𢦒	戈 𰀁 
𢦔	戈 才 
𢦕	戈 凣 
𢦚	戈 丮 
𢦟	戈 今 
𢦣	戈 日 
𢦦	戈 甲 
𢦲	戊 斤 
𢦴	戈 主 
𢦸	吅 戈 
𢦺	从 二 戈 
𢦼	𢦏 爪 
𢦽	戊 召 
𢦿	辰 戈 
𢧀	旱 戈 
𢧄	呈 戈 
𢧅	余 戈 
𢧇	夌 戈 
𢧈	豖 戈 
𢧏	忝 戈 
𢧑	𢦏 口 土 
𢧖	丁 戛 
𢧗	占 戔 
𢧜	𢦏 呈 
𢧞	冫 戊 舟 
𢧢	倝 戈 
𢧤	戜 大 
𢧥	兼 戈 
𢧦	戊 要 
𢧧	束 戒 
𢧮	䀠 戈 
𢧰	𠃊 軍 戈 
𢧱	桑 戈 
𢧳	庸 戈 
𢧴	敖 戈 
𢧵	雀 戈 
𢧻	丁 𦣻 冖 戈 
𢧽	鹵 戈 
𢨁	戈 厶 韭 
𢨏	世 𠕋 𢦍 
𢨐	吅 䏍 戈 
𢨒	童 戈 
𢨔	僉 戈 
𢨗	𩡱 戈 
𢨜	戈 工 䖵 
𢨝	蔡 戈 
𢨟	⺊ 囗 各 咸 
𢨡	禾 戈 䖵 
𢨥	一 戶 
𢨦	戶 十 
𢨨	户 人 
𢨫	户 土 
𢨮	户 千 
𢨰	户 父 
𢨱	户 公 
𢨲	戶 方 
𢨺	戶 卯 
𢨿	户 丙 
𢩁	戶 句 
𢩄	戶 汁 
𢩈	戶 至 
𢩏	户 𦈢 
𢩐	户 今 山 
𢩑	戶 夌 
𢩒	戶 肥 
𢩓	戶 幸 
𢩖	戶 臿 
𢩗	𡰥 𢨳 
𢩘	戶 盍 
𢩞	户 辛 爪 
𢩟	夾 扁 
𢩠	戶 睘 
𢩡	𢨪 六 白 八 
𢩢	戶 毚 
𢩦	⺄ 手 
𢩨	扌 丂 
𢩪	扌 了 
𢩮	扌 弋 
𢩯	扌 了 一 
𢩰	扌 ⺇ 丨 
𢩲	扌 ⺄ 十 
𢩷	手 乇 
𢩸	夂 手 
𢩹	扌 下 
𢩻	扌 么 
𢩼	扌 幺 
𢪂	扌 大 
𢪃	扌 切 
𢪇	爿 手 
𢪈	扌 冄 
𢪋	扌 丰 
𢪍	扌 尐 
𢪎	扌 化 
𢪏	扌 曰 
𢪑	扌 旡 
𢪠	扌 中 
𢪥	手 勿 
𢪦	扌 厂 匕 
𢪧	扌 牛 
𢪪	扌 丐 
𢪬	扌 孔 
𢪱	扌 勿 
𢪶	扌 号 
𢪷	扌 目 
𢪼	扌 𠬦 
𢪾	扌 四 
𢫆	扌 本 
𢫈	扌 古 
𢫐	扌 小 𠆢 
𢫓	扌 奴 
𢫔	扌 玄 
𢫕	扌 永 
𢫘	扌 卢 
𢫢	扌 丿 水 
𢫦	扌 百 
𢫧	扌 州 
𢫩	扌 休 
𢫫	扌 聿 
𢫬	扌 杀 
𢫭	扌 肉 
𢫯	扌 伏 
𢫰	舛 手 
𢫲	扌 㕂 
𢫴	次 手 
𢫵	扌 早 
𢫷	扌 ⺁ 巴 
𢫸	扌 吳 
𢫻	扌 丟 
𢫿	扌 𠫤 
𢬀	扌 扛 
𢬫	承 丁 
𢬬	承 㔾 
𢬱	扌 劫 
𢬲	扌 何 
𢬳	扌 禿 
𢬴	扌 耴 
𢬵	扌 弃 
𢬷	扌 内 口 
𢬼	扌 囤 
𢬾	扌 希 
𢬿	扌 戒 
𢭁	扌 系 
𢭂	扌 牢 
𢭄	扌 忌 
𢭅	扌 干 火 
𢭆	扌 秀 
𢭈	扌 彐 一 山 
𢭎	扌 夅 
𢭏	扌 寿 
𢭥	手 ⺇ 手 
𢭦	扌 孝 
𢭧	扌 𠆢 出 
𢮃	𥝢 手 
𢮄	扌 㦿 
𢮌	扌 劼 
𢮚	扌 昊 
𢮞	扌 㕚 爪 
𢯅	扌 坴 
𢯉	扌 𤓻 
𢯋	扌 斧 
𢯌	扌 𢪘 
𢯦	扌 來 
𢯭	扌 帣 
𢯱	扌 叜 
𢯳	扌 爫 巳 又 
𢰇	扌 俟 
𢰊	扌 吅 寸 
𢰒	扌 𦚉 
𢰿	𢪒 目 
𢱄	扌 爫 𭅲 又 
𢱊	扌 亰 
𢱌	扌 架 
𢱟	扌 蚩 
𢱢	扌 索 
𢱣	扌 脊 
𢱤	扌 送 
𢱦	扌 剔 
𢱧	扌 𣬉 
𢱨	扌 紊 
𢱮	扌 𥁑 
𢱴	扌 枽 
𢱶	扌 𬔰 
𢱷	扌 埐 
𢱺	扌 皮 皮 
𢱽	扌 㤪 
𢱾	扌 覀 火 
𢲔	扌 班 
𢲫	扌 馬 
𢲰	扌 𦚧 
𢲴	尉 手 
𢲵	扌 曹 
𢲶	扌 笡 
𢲷	扌 窔 
𢲸	扌 鹵 
𢲼	扌 窒 
𢲽	扌 ⺁ 𧆞 
𢲾	扌 閉 
𢲿	𥬑 手 
𢳀	扌 麻 
𢳁	䨾 手 
𢳂	扌 畢 
𢳃	扌 焉 
𢳄	扌 旋 
𢳇	扌 族 
𢳈	族 手 
𢳋	扌 庳 
𢳎	扌 𠦪 
𢳑	扌 莨 
𢳓	扌 𰩶 
𢳙	扌 窕 
𢳚	扌 梟 
𢳛	扌 虍 旦 
𢳟	扌 通 
𢳽	扌 利 双 
𢳾	扌 動 
𢴂	扌 匾 
𢴒	扌 𪸿 
𢴚	扌 匿 
𢴠	扌 戠 
𢴢	扌 賁 
𢴦	扌 項 
𢴧	扌 貳 
𢴨	扌 啻 
𢴩	扌 筆 
𢴪	扌 款 
𢴬	扌 斑 
𢴭	絕 手 
𢴮	扌 虛 
𢴰	扌 幾 
𢴱	扌 絫 
𢴲	扌 絜 
𢴳	湯 手 
𢴾	扌 悲 
𢵇	扌 卝 土 永 
𢵈	扌 善 
𢵣	扌 惡 
𢵥	稍 手 
𢵮	扌 矞 
𢶀	扌 罪 
𢶃	扌 煩 
𢶅	扌 筮 
𢶇	扌 煢 
𢶉	扌 雹 
𢶋	扌 𢧜 
𢶌	扌 𬕍 
𢶍	扌 䪞 
𢶑	扌 裊 
𢶒	扌 會 
𢶓	扌 辠 
𢶡	敫 手 
𢶣	扌 叠 
𢶳	扌 云 枼 
𢶴	扌 慈 
𢶶	扌 意 
𢷃	扌 閙 
𢷅	扌 路 
𢷑	扌 㬎 
𢷔	扌 旖 
𢷕	扌 貌 
𢷖	扌 㡭 
𢷗	扌 聚 
𢷙	扌 箜 
𢷢	扌 鄣 
𢷶	扌 劉 
𢷸	扌 徵 
𢷹	扌 廛 
𢷺	扌 賣 
𢷻	扌 緣 
𢷾	扌 慼 
𢷿	扌 𢧵 
𢸀	扌 隷 
𢸁	興 手 
𢸌	扌 龵 ⻏ 帛 
𢸗	扌 虢 
𢸘	扌 寮 
𢸙	扌 審 
𢸣	扌 褭 
𢸥	扌 篡 
𢸦	扌 遺 
𢸨	扌 橐 
𢸫	扌 穌 
𢸭	龍 手 
𢸳	扌 蕭 
𢸴	扌 閻 
𢹃	扌 穎 
𢹍	扌 戲 
𢹎	扌 𦣻 止 丨 丨 巳 夂 
𢹏	輿 手 
𢹑	扌 䆸 
𢹒	扌 燮 
𢹓	扌 齋 
𢹔	扌 糞 
𢹖	扌 馘 
𢹘	扌 擎 
𢹙	扌 炎 面 
𢹚	扌 䯹 
𢹝	扌 霝 
𢹥	扌 壓 
𢹬	扌 雝 
𢹮	扌 壘 
𢹲	扌 麏 
𢹳	扌 𰥇 
𢹼	扌 雜 
𢺄	扌 關 
𢺅	扌 簽 
𢺆	扌 䇔 
𢺈	扌 䜌 
𢺉	扌 蠆 
𢺑	扌 羸 
𢺞	扌 霸 
𢺟	扌 羼 
𢺡	扌 屬 
𢺫	扌 冐 永 定 
𢺯	扌 彎 
𢺰	扌 靈 
𢺴	扌 鬱 
𢺵	匕 支 
𢺷	巿 支 
𢺼	斤 支 
𢺽	㐅 㐅 支 
𢺿	世 支 
𢻀	𡰥 支 
𢻂	缶 支 
𢻅	曲 支 
𢻇	名 支 
𢻉	亥 支 
𢻋	支 呂 
𢻓	享 支 
𢻔	果 支 
𢻗	臿 支 
𢻘	广 圭 支 
𢻙	枲 支 
𢻚	桑 支 
𢻜	害 支 
𢻟	宀 炎 支 
𢻠	雇 支 
𢻢	尞 支 
𢻤	喬 支 
𢻨	䪞 支 
𢻪	器 支 
𢻫	也 攴 
𢻮	卪 攵 
𢻱	也 攵 
𢻲	亾 攴 
𢻵	巿 攴 
𢻶	今 攴 
𢻷	巴 攴 
𢻸	勻 攴 
𢻹	比 攵 
𢻼	冘 攴 
𢻿	攴 月 
𢼖	𡰥 攴 
𢼙	兄 攵 
𢼚	戹 攵 
𢼛	各 攴 
𢼟	𡉚 攴 
𢼠	八 𠃔 攵 
𢼣	吉 攴 
𢼤	舌 攴 
𢼦	共 攴 
𢼩	并 攴 
𢼫	㐅 㐅 㐅 攵 
𢼰	曲 攴 
𢼱	𠕎 攴 
𢼲	朱 攴 
𢼳	匡 攵 
𢼵	亥 攵 
𢼷	异 攵 
𢼸	山 攵 一 几 
𢼹	甫 攴 
𢼺	折 攴 
𢼼	肖 攴 
𢽂	攴 良 
𢽃	山 王 攴 
𢽄	廷 攴 
𢽎	旱 攵 
𢽕	見 攴 
𢽖	𠬶 攴 
𢽗	山 止 攵 
𢽚	豖 攴 
𢽜	尿 攴 
𢽝	隹 攴 
𢽢	冐 攴 
𢽦	空 攴 
𢽧	周 攴 
𢽨	忽 攴 
𢽩	朋 攴 
𢽭	𠧢 攴 
𢽴	豖 攵 
𢽸	𡶤 攵 
𢽹	昏 攵 
𢽾	学 攴 
𢾀	者 攴 
𢾁	韋 攴 
𢾃	𠧪 攴 
𢾄	俞 攵 
𢾅	度 攵 
𢾆	皆 攴 
𢾇	畐 攴 
𢾊	亭 攴 
𢾎	春 攴 
𢾐	叜 攴 
𢾑	音 攴 
𢾒	𡧱 攴 
𢾔	𥄎 夬 
𢾝	韋 攵 
𢾦	乗 攴 
𢾧	烝 攴 
𢾩	盍 攴 
𢾪	桑 攴 
𢾫	蚩 攴 
𢾬	亠 丷 灰 攴 
𢾭	尃 攵 
𢾱	𣬉 攴 
𢾲	弱 攴 
𢾳	草 攵 
𢾺	匪 攵 
𢾿	鬲 攴 
𢿂	𠩺 干 
𢿈	參 攴 
𢿎	皐 攴 
𢿏	票 攴 
𢿚	㕛 斤 山 攴 
𢿜	曼 攵 
𢿞	尞 攴 
𢿡	𣦵 攴 貝 
𢿣	堯 攴 
𢿤	登 攴 
𢿦	牚 攴 
𢿧	棠 攴 
𢿭	𢼄 卓 
𢿱	𢽳 ⺝ 
𢿲	堯 攵 
𢿸	策 攴 
𣀀	雷 攴 
𣀁	詹 攴 
𣀂	豊 攴 
𣀃	廉 攴 
𣀄	君 ⺸ 攴 
𣀆	羣 攵 
𣀏	尚 甘 攴 
𣀐	自 幸 攵 
𣀒	聚 攴 
𣀓	壽 攴 
𣀔	算 攴 
𣀘	壽 攵 
𣀜	畾 攴 
𣀝	樂 攴 
𣀞	慮 攴 
𣀣	觱 攴 
𣀥	歷 攴 
𣀧	㪔 隹 
𣀫	𤯌 攴 
𣀯	麻 耳 攴 
𣀳	聶 攵 
𣀶	贊 攴 
𣀷	麗 攴 
𣀻	屬 攴 
𣀾	或 或 角 攴 
𣁉	必 文 
𣁒	廿 丨 𣁁 
𣁖	𠦝 文 
𣁗	炭 文 
𣁜	曼 文 
𣁟	𠩺 文 
𣁢	敝 文 
𣁦	斌 全 
𣁭	𠃔 斗 
𣁯	斗 元 
𣁰	斗 斤 
𣁳	⾆ 斗 
𣁴	合 斗 
𣁵	羊 斗 
𣁷	寽 斗 
𣁹	斗 酉 
𣁻	斗 寽 
𣂀	𠩓 斗 
𣂁	庣 斗 
𣂄	咼 斗 
𣂆	旁 斗 
𣂇	斗 厞 
𣂉	啇 斗 
𣂊	尉 斗 
𣂒	力 斤 
𣂖	开 斤 
𣂗	井 斤 
𣂜	臣 斤 
𣂝	斤 向 
𣂞	良 斤 
𣂤	朋 斤 
𣂥	⺁ 兆 斤 
𣂮	俞 斤 
𣂳	亭 斤 
𣂴	斤 亭 
𣂵	彖 斤 
𣂻	區 斤 
𣂽	國 斤 
𣃄	菁 斤 
𣃅	斤 㓁 兔 
𣃈	著 斤 
𣃉	斤 當 
𣃍	算 斤 
𣃑	箸 斤 
𣃔	𢇍 斤 
𣃗	方 刀 
𣃘	㫃 丨 
𣃚	方 亢 
𣃝	方 央 
𣃧	𭤨 日 
𣃳	𭤨 㘝 
𣃵	𭤨 申 
𣃽	𭤨 多 
𣃾	方 奄 
𣄅	方 亼 丅 口 
𣄉	𭤨 酉 
𣄍	方 是 
𣄎	方 尃 
𣄏	方 畚 
𣄑	𭤨 奄 
𣄓	方 竹 毛 
𣄙	𭤨 晃 
𣄜	方 貴 
𣄝	方 僉 
𣄠	𭤨 猋 
𣄧	𭤨 遺 
𣄮	旡 口 
𣄯	凣 旡 
𣄰	旡 可 
𣄱	旡 圭 
𣄲	旡 危 
𣄴	旡 京 
𣄸	旡 咼 
𣄺	旡 爲 
𣄻	日 乙 
𣄿	日 丁 
𣅃	日 卜 
𣅄	廴 日 
𣅉	日 刃 
𣅍	囗 日 
𣅚	日 內 
𣅜	比 日 
𣅝	日 八 又 
𣅞	𨈐 日 
𣅟	日 冘 
𣅡	日 夬 
𣅤	日 犬 
𣅥	日 互 
𣅰	丐 日 
𣅷	日 兄 
𣅺	日 幼 
𣅻	日 冋 
𣅾	冉 日 
𣆈	日 戊 
𣆍	日 方 ⺃ 
𣆐	日 卢 
𣆑	册 日 
𣆒	日 戍 
𣆔	日 舟 
𣆕	劦 日 
𣆖	日 巟 
𣆗	日 合 
𣆘	日 吏 
𣆙	日 汗 
𣆚	日 多 
𣆛	覀 日 
𣆟	此 旦 
𣆧	日 兀 兀 
𣆳	日 更 
𣆴	日 延 
𣆵	日 𦥑 
𣆽	旦 𤘖 
𣇇	延 旦 
𣇖	昍 工 
𣇗	日 厂 ⺕ 又 
𣇙	皃 日 
𣇢	日 㡀 
𣇦	日 垂 
𣇧	日 炙 
𣇨	日 隶 
𣇫	日 果 
𣇬	日 穹 
𣇰	日 林 
𣇲	日 昏 
𣇳	日 其 
𣇵	日 明 
𣇶	彐 彐 冖 日 
𣈅	林 日 
𣈊	牧 日 
𣈍	日 宜 
𣈎	日 𦊋 
𣈡	是 丈 
𣈥	日 俞 
𣈶	日 恆 
𣉄	丰 是 
𣉅	日 奏 
𣉆	日 是 
𣉒	日 隺 
𣉓	日 𡌥 
𣉕	日 桑 
𣉖	日 烜 
𣉗	日 盎 
𣉘	能 日 
𣉚	日 牂 
𣉛	日 耳 斤 
𣉜	日 殺 
𣉡	旱 廷 
𣉩	亞 八 日 
𣉪	日 荒 
𣉮	日 真 
𣉾	日 區 
𣉿	日 曹 
𣊁	敖 日 
𣊃	務 日 
𣊓	執 日 
𣊖	晶 大 
𣊝	日 土 龷 木 
𣊞	日 欻 
𣊟	日 敢 
𣊶	日 敝 
𣊺	日 間 
𣋄	昔 享 
𣋉	日 奧 
𣋊	日 亶 
𣋋	日 黽 
𣋌	日 𠌶 
𣋏	日 農 
𣋘	日 會 
𣋞	日 蓋 
𣋟	日 麽 
𣋢	日 兢 
𣋣	日 監 
𣋲	日 巤 
𣋳	日 麃 
𣋵	日 樂 
𣋶	日 窮 
𣋹	日 弊 
𣋿	亠 多 隹 日 
𣌅	⺜ 歷 
𣌍	日 聶 
𣌏	㝵 蒦 
𣌓	日 雚 
𣌗	日 矍 
𣌚	旦 言 景 
𣌜	星 歷 
𣌞	普 養 
𣌟	日 靈 
𣌧	冊 曰 
𣌨	申 勻 
𣌭	合 曰 
𣌾	申 東 
𣍃	柬 申 
𣍆	殸 曰 
𣍇	更 取 
𣍏	更 差 
𣍐	勿 會 
𣍖	曹 東 
𣍛	更 轝 
𣍟	冖 一 月 
𣍦	月 兄 
𣍧	出 月 
𣍯	月 军 
𣍰	月 夹 
𣍴	月 歹 巳 
𣍸	𭁨 月 
𣍺	月 小 生 
𣎄	月 恆 
𣎅	月 曷 
𣎆	亡 口 月 凡 
𣎎	𰮤 仌 
𣎑	月 宽 
𣎓	月 旋 
𣎔	月 現 
𣎚	月 黑 
𣎛	月 矞 
𣎟	月 尋 
𣎩	厭 ⺝ 
𣎮	月 羲 
𣎱	月 昍 丶 𤕫 矢 
𣎲	月 黨 
𣎸	木 了 
𣏀	木 刂 
𣏌	木 巳 
𣏎	木 丫 
𣏑	木 巾 
𣏔	止 木 
𣏖	木 引 
𣏗	予 木 
𣏚	木 氏 
𣏞	木 尤 
𣏟	𣎳 𣎳 
𣏠	木 爻 
𣏡	木 龰 
𣏥	木 六 
𣏫	木 𡯄 
𣏶	木 水 
𣏷	𠕀 木 
𣏺	木 孔 
𣐂	云 木 
𣐃	厄 木 
𣐊	木 尻 
𣐋	木 戉 
𣐎	木 瓦 
𣐏	木 㘝 
𣐑	木 此 
𣐓	木 𡰥 
𣐤	木 旧 
𣐩	白 木 
𣐫	一 水 木 
𣐬	木 田 
𣐮	囚 木 
𣐯	出 木 
𣐵	木 𦣝 
𣐿	木 衣 
𣑁	木 充 
𣑂	木 爫 丂 
𣑃	汎 木 
𣑦	巩 木 
𣑧	𣏉 土 
𣑮	木 舟 
𣑯	木 兆 
𣑸	同 木 
𣑹	木 山 巾 
𣑿	木 爫 巳 
𣒂	木 立 卩 
𣒃	木 役 
𣒄	木 些 
𣒅	木 𠯌 
𣒆	木 壳 
𣒇	木 禿 
𣒍	木 何 
𣒷	广 㦿 
𣒸	木 兀 王 
𣒹	木 少 女 
𣒻	木 气 土 
𣒼	攸 木 
𣓀	辛 木 
𣓁	𭑈 木 
𣓃	木 芮 
𣓅	木 㦿 
𣓆	木 㸒 
𣓈	木 兩 
𣓉	木 疌 
𣓊	木 事 
𣓋	木 芘 
𣓌	木 咎 
𣓐	木 油 
𣓒	木 芟 
𣓔	弥 木 
𣓕	林 厹 
𣓗	木 曶 
𣓛	木 自 匕 
𣔐	木 㡀 
𣔓	木 彼 
𣔗	枲 凡 
𣔘	圭 刀 木 
𣔙	木 欣 
𣔚	服 木 
𣔛	木 穴 兀 
𣔫	木 𠂉 圭 
𣔬	木 𠬦 廾 
𣔮	木 𢦏 丂 
𣔯	木 雨 
𣔱	木 叜 
𣔲	木 迥 
𣔵	㲋 木 
𣔶	木 范 
𣔷	木 月 夰 
𣔹	木 矦 
𣔺	木 冒 
𣔻	木 突 
𣔼	木 竿 
𣔽	癸 木 
𣔾	木 㒸 
𣕁	娃 木 
𣕃	木 禺 
𣕄	木 扃 
𣕅	木 壬 包 
𣕇	削 木 
𣕉	木 苟 
𣕋	木 㞕 
𣕌	木 敂 
𣕍	木 旬 大 
𣕎	林 田 
𣕏	亠 田 厶 木 
𣕾	林 必 
𣖄	臿 木 
𣖅	木 ⺁ 辛 
𣖆	木 㝁 
𣖉	木 穼 
𣖊	木 𣧄 刂 
𣖌	木 支 只 
𣖐	木 迫 
𣖤	來 台 
𣖨	木 茈 
𣖪	木 虍 木 
𣖫	㱿 木 
𣖬	木 欮 
𣖭	木 𡌥 
𣖮	木 盎 
𣖯	木 𬔰 
𣖰	木 笓 
𣖱	木 𭖨 
𣖳	木 䖍 
𣖵	木 座 
𣖷	木 脊 
𣖸	木 广 辛 
𣖹	木 挐 
𣖻	木 右 皿 
𣖼	木 𠣬 
𣖾	木 𤰇 
𣖿	木 弋 貝 
𣗁	石 柘 
𣗐	木 郢 
𣗬	木 臭 
𣗲	求 干 木 
𣗳	木 𭔰 
𣗵	木 罡 
𣗶	木 眔 
𣗹	木 恙 
𣗺	枲 古 
𣗻	枲 失 
𣘖	木 梟 
𣘘	木 莘 
𣘙	木 部 
𣘚	木 率 
𣘛	木 兜 
𣘝	木 䙴 
𣘞	木 酓 
𣘟	假 木 
𣘠	木 笴 
𣘣	木 脣 
𣘤	木 祭 
𣘥	木 閉 
𣘦	殹 木 
𣘧	木 符 
𣘨	木 𧙃 
𣘪	木 聊 
𣘫	呆 虎 
𣘬	𠩺 木 
𣘱	木 得 
𣘲	木 梓 
𣘴	木 银 
𣘷	木 笺 
𣘻	木 荼 
𣙗	執 木 
𣙛	木 吝 ⺝ 
𣙟	木 常 
𣙢	木 圈 
𣙰	尼 桑 
𣙱	木 笱 
𣙴	木 尤 谷 
𣙵	木 淂 
𣙷	木 莽 
𣙻	木 菆 
𣙼	辝 木 
𣙿	木 費 
𣚀	木 觜 
𣚁	木 貲 
𣚃	木 絜 
𣚄	斯 木 
𣚆	木 屯 屯 屯 
𣚇	𰀉 冖 木 包 
𣚋	木 𦳃 
𣚌	木 啻 
𣚍	木 𠶷 
𣚎	木 絫 
𣚏	亠 䀠 木 
𣚒	木 琶 
𣚓	木 糸 䏍 
𣚔	木 舄 
𣚕	木 猒 
𣚖	木 菴 
𣚘	減 木 
𣚙	木 牋 
𣚜	木 䓗 
𣚝	木 𮕹 
𣚟	木 歰 
𣚠	木 黹 
𣚡	木 棐 
𣚢	木 𰺿 
𣚦	木 强 
𣚧	𭈹 木 
𣚩	启 古 木 
𣛓	木 𨱥 
𣛔	木 戟 
𣛗	木 笿 
𣛚	木 惢 
𣛫	木 丳 火 
𣛮	木 盛 
𣛱	木 窞 
𣛴	木 感 
𣛵	木 皵 
𣛶	木 煞 
𣛷	木 盞 
𣛸	木 賊 
𣛹	木 遄 
𣛺	木 厀 
𣛻	木 牒 
𣛽	木 禾 亞 
𣛾	㮊 𠫗 
𣜁	木 此 隹 
𣜂	木 䪞 
𣜄	𣎆 木 
𣜇	木 𧵩 
𣜢	果 禺 
𣜣	喿 冘 
𣜦	道 木 
𣜧	木 𤇾 𠁽 
𣜨	枲 卷 
𣜬	木 愛 
𣜭	木 煎 
𣜹	桑 弟 
𣜺	林 冖 尸 巴 
𣜽	桑 成 
𣝁	木 箄 
𣝂	木 䰟 
𣝅	木 疑 
𣝇	木 䀠 木 
𣝈	木 蒹 
𣝉	木 對 
𣝋	木 遝 
𣝌	木 緊 
𣝍	木 蒪 
𣝎	木 竹 炎 
𣝏	木 蒿 
𣝐	𰀉 冖 臼 木 
𣝑	與 木 
𣝒	榼 木 
𣝕	木 箋 
𣝗	木 ⺼ 骨 
𣝚	㼲 木 
𣝜	枲 扁 
𣝝	士 冗 殳 束 
𣝞	束 巢 
𣝸	木 蓆 
𣝼	木 自 㓁 𠔽 
𣝽	木 𭅞 
𣞇	誩 木 
𣞐	木 寫 
𣞑	木 甍 
𣞒	木 敷 
𣞓	木 蔍 
𣞔	木 歎 
𣞕	木 蓺 
𣞗	木 劉 
𣞘	木 匚 僉 
𣞙	壴 桑 
𣞝	木 憃 
𣞟	枲 真 
𣞤	𡘲 林 
𣞰	柬 桑 
𣞴	梨 居 
𣟀	木 辶 莑 
𣟁	木 墮 
𣟄	木 橐 
𣟆	木 遼 
𣟇	木 翏 皿 
𣟉	衞 木 
𣟊	木 褭 
𣟋	木 褰 
𣟌	木 隷 
𣟐	木 亠 翟 
𣟑	橙 寸 
𣟒	木 𠦜 林 
𣟤	木 穎 
𣟦	華 𣏋 
𣟰	輿 木 
𣟲	木 鮮 
𣟳	木 還 
𣟴	木 𢩠 
𣟵	木 戲 
𣟸	木 麋 
𣟹	木 篸 
𣟺	木 斂 
𣟼	枲 焦 
𣟽	枲 勞 
𣠎	枲 堯 
𣠏	枲 最 
𣠚	木 霤 
𣠜	木 翟 火 
𣠞	聶 木 
𣠠	木 壘 
𣠭	木 𢇕 
𣠷	木 繭 
𣠸	木 關 
𣠹	木 纂 
𣠺	木 簽 
𣠼	木 𨶪 
𣡉	桑 奧 
𣡊	木 藝 
𣡋	木 共 爾 
𣡌	木 獻 
𣡎	木 鬯 秦 
𣡞	木 䦲 
𣡟	木 畾 冖 夕 一 
𣡠	木 䀠 曼 
𣡧	木 罍 
𣡩	木 彎 
𣡰	𠆢 𣡗 
𣡶	木 鹽 
𣡺	𤳳 𣑩 
𣢁	尸 欠 
𣢂	尸 欠 
𣢄	幺 欠 
𣢅	亡 欠 
𣢆	乞 欠 
𣢇	己 欠 
𣢉	化 欠 
𣢊	勿 欠 
𣢋	比 欠 
𣢌	冘 欠 
𣢍	兮 欠 
𣢎	氏 欠 
𣢏	分 欠 
𣢑	㞢 欠 
𣢒	少 欠 
𣢓	廿 欠 
𣢕	旡 欠 
𣢖	户 欠 
𣢗	甲 欠 
𣢚	瓜 欠 
𣢛	戶 乙 欠 
𣢜	幼 欠 
𣢝	令 欠 
𣢞	尼 欠 
𣢟	甘 欠 
𣢠	必 欠 
𣢡	生 欠 
𣢤	占 欠 
𣢥	丘 欠 
𣢦	立 欠 
𣢨	后 欠 
𣢪	危 欠 
𣢫	𡉚 欠 
𣢬	㕂 欠 
𣢭	𣱷 欠 
𣢰	尗 欠 
𣢲	八 今 欠 
𣢳	⺧ 力 欠 
𣢴	𠂉 开 欠 
𣢶	至 欠 
𣢷	各 欠 
𣢺	含 欠 
𣢻	上 水 欠 
𣣈	念 欠 
𣣉	兒 欠 
𣣊	呰 欠 
𣣋	夌 欠 
𣣌	死 次 
𣣎	育 欠 
𣣏	昏 欠 
𣣑	必 土 欠 
𣣒	斤 欥 
𣣚	奄 欠 
𣣜	糸 力 欠 
𣣝	卽 欠 
𣣞	軍 欠 
𣣟	客 欠 
𣣠	侯 欠 
𣣡	矦 欠 
𣣣	𡱒 欠 
𣣩	大 亠 日 欠 
𣣭	厙 欠 
𣣮	𡸁 欠 
𣣲	脅 欠 
𣣳	䍃 欠 
𣣴	𥄳 欠 
𣣵	羔 欠 
𣣶	害 欠 
𣣷	蚩 欠 
𣣸	𠧴 欠 
𣣹	盍 欠 
𣣿	士 冖 台 欠 
𣤁	彧 欠 
𣤃	𣢾 乃 
𣤇	隺 欠 
𣤈	責 欠 
𣤊	習 欠 
𣤋	婁 欠 
𣤌	欼 口 
𣤎	辶 肖 欠 
𣤖	軗 欠 
𣤘	斯 欠 
𣤡	奧 欠 
𣤢	𣪠 欠 
𣤩	翟 欠 
𣤪	羽 金 欠 
𣤭	咸 糸 欠 
𣤯	賣 欠 
𣤰	樂 欠 
𣤱	毚 欠 
𣤲	噩 欠 
𣤳	直 彼 欠 
𣤴	戲 欠 
𣤵	嬰 欠 
𣤶	鼀 欠 
𣤷	士 㠯 㠯 木 欠 
𣤹	米 焦 欠 
𣤺	士 ⺫ 䀠 欠 
𣤿	鰥 欠 
𣥃	止 ⺃ 
𣥇	止 卂 
𣥊	亡 止 
𣥐	止 从 
𣥞	止 井 
𣥡	止 毛 
𣥣	止 皮 
𣥤	止 田 
𣥥	此 千 
𣥨	此 及 
𣥮	止 圭 
𣥯	止 有 
𣥰	止 𠆸 
𣥳	余 止 
𣥶	止 日 𣥂 
𣥷	止 夂 中 
𣥹	止 叔 
𣥺	尚 止 
𣥻	止 夌 
𣥼	止 凵 吅 
𣥾	止 沓 
𣦇	止 复 
𣦉	止 省 
𣦌	止 癸 
𣦏	武 丗 
𣦐	止 罡 
𣦖	卓 步 
𣦜	止 喬 
𣦠	止 屠 
𣦡	止 著 
𣦢	辟 止 
𣦦	歲 目 
𣦩	止 皷 
𣦪	㕛 臣 㕛 止 
𣦫	歲 印 
𣦬	止 𫀄 出 
𣦭	歲 屾 
𣦯	厤 厽 止 
𣦵	⺊ 𠔼 
𣦼	歺 又 
𣧂	歹 大 
𣧃	歹 乇 
𣧄	巛 歹 
𣧈	歹 山 
𣧊	歹 丑 
𣧌	歹 戈 
𣧍	歹 內 
𣧎	歹 夬 
𣧏	歹 攴 
𣧒	歹 𡕒 
𣧖	歹 尐 
𣧗	歹 尤 
𣧘	歹 牛 
𣧙	歹 手 
𣧚	⺼ 歹 
𣧛	歹 火 
𣧜	歹 巴 
𣧝	歹 囚 
𣧡	歹 戉 
𣧣	歹 末 
𣧤	歹 可 
𣧥	歹 幼 
𣧦	歹 布 
𣧧	歹 犮 
𣧬	歹 句 
𣧲	歹 米 
𣧳	歹 各 
𣧵	歹 戌 
𣧷	歹 朵 
𣧹	歹 耳 
𣧻	歹 肉 
𣧼	歹 危 
𣧽	歹 𭗼 
𣧾	歹 艮 
𣧿	歹 列 
𣨀	不 死 
𣨂	歹 至 
𣨄	歺 合 
𣨅	歹 寽 
𣨇	歹 丣 
𣨉	歹 亨 
𣨊	歹 扌 片 
𣨋	歹 折 
𣨍	歹 角 
𣨎	歹 坐 
𣨓	歹 告 
𣨔	歹 伯 
𣨗	析 歹 
𣨘	歹 芺 
𣨙	歹 委 
𣨛	歹 卒 
𣨜	歹 夜 
𣨝	歹 於 
𣨞	歹 奉 
𣨟	歹 易 
𣨠	歹 芯 
𣨡	歹 岳 
𣨢	歹 屈 
𣨣	歹 京 
𣨤	歹 或 
𣨥	歹 朋 
𣨪	歹 果 
𣨫	歹 隹 
𣨲	歹 度 
𣨳	𨚌 共 
𣨶	歹 彖 
𣨺	歹 骨 
𣨾	歹 星 
𣨿	歹 軍 
𣩀	歹 扁 
𣩄	歹 盍 
𣩅	歹 高 
𣩈	歹 差 
𣩏	歹 鹿 
𣩑	歹 崔 
𣩒	歹 曹 
𣩓	歹 巢 
𣩔	歹 貫 
𣩙	歹 焉 
𣩜	歹 竟 
𣩟	歹 登 
𣩠	歹 斯 
𣩡	歹 最 
𣩢	歹 尞 
𣩧	歹 善 
𣩩	辟 歹 
𣩪	歹 歲 
𣩫	歹 業 
𣩭	欲 死 
𣩯	歹 㬎 
𣩰	歹 翟 
𣩱	歹 蓋 
𣩴	强 死 
𣩷	歹 䔡 
𣩹	歹 褱 
𣩺	𦥑 同 死 
𣩽	歹 襄 
𣪀	歹 顛 
𣪁	歹 贊 
𣪂	丹 殳 
𣪄	欠 殳 
𣪇	古 殳 
𣪉	口 尸 殳 
𣪌	豆 殳 
𣪐	𠃬 殳 
𣪕	㿝 殳 
𣪘	皀 殳 
𣪠	𨊥 殳 
𣪨	士 冖 殳 天 
𣪪	疒 𠮛 殳 
𣪭	龶 目 殳 
𣪮	宰 殳 
𣪯	宮 殳 
𣪶	參 殳 
𣪹	𣪊 出 
𣫀	士 冖 殳 告 
𣫆	殸 正 
𣫈	士 冖 殳 酉 
𣫉	穀 乃 
𣫌	𣪊 孚 
𣫎	𣪊 束 
𣫐	壽 殳 
𣫒	殸 巠 
𣫔	𣪊 豖 
𣫙	殸 杲 
𣫜	殸 卓 
𣫝	殸 空 
𣫣	殸 蛬 
𣫥	殹 康 
𣫧	藶 殳 
𣫨	殸 亼 ⺫ 皿 
𣫪	穀 會 
𣫱	云 毋 
𣫳	毋 冊 
𣫴	圭 母 
𣫹	甲 毒 
𣬂	比 干 
𣬆	比 反 
𣬈	囟 比 
𣬉	囟 比 
𣬎	㲋 夬 
𣬏	北 ⺫ 比 
𣬐	㲋 史 
𣬕	㲋 吾 
𣬘	比 ⺫ 比 灷 
𣬙	咅 比 竞 
𣬚	㲋 兔 兔 
𣬝	毛 了 
𣬠	毛 几 
𣬩	分 毛 
𣬪	巿 毛 
𣬫	毛 介 
𣬬	毛 及 
𣬮	匹 毛 
𣬴	毛 欠 
𣬵	方 毛 
𣬶	毛 巴 
𣬷	巴 毛 
𣬸	召 毛 
𣬹	令 毛 
𣬺	生 毛 
𣬻	氶 毛 
𣬼	毛 皮 
𣬽	毛 戊 
𣬿	毛 乍 
𣭀	包 毛 
𣭇	毛 母 
𣭖	号 毛 
𣭗	毛 𪠲 
𣭘	弗 毛 
𣭙	毛 尼 
𣭝	毛 合 
𣭠	如 毛 
𣭡	先 毛 
𣭤	毛 比 十 
𣭮	龹 毛 
𣭲	甬 毛 
𣭳	求 毛 
𣭷	孛 毛 
𣭹	夭 干 毛 
𣮃	毛 呆 
𣮄	毛 妥 
𣮆	兌 毛 
𣮈	屈 毛 
𣮉	來 毛 
𣮊	㝵 毛 
𣮌	疌 毛 
𣮍	毛 妾 
𣮎	毛 昆 
𣮏	毛 戔 
𣮐	毛 卑 
𣮡	奔 毛 
𣮢	享 毛 
𣮦	奈 毛 
𣮧	並 毛 
𣮪	柔 毛 
𣮫	叚 毛 
𣮬	毛 叜 
𣮰	目 木 毛 
𣮾	士 米 毛 
𣮿	面 毛 
𣯀	毛 冒 
𣯃	咨 毛 
𣯅	厂 炎 毛 
𣯆	耆 毛 
𣯋	毛 辱 
𣯌	娑 毛 
𣯍	毛 隼 
𣯎	𥁕 毛 
𣯏	毛 茸 
𣯐	毛 𩠐 
𣯚	毛 荅 
𣯜	毛 叟 
𣯤	毛 离 
𣯧	毛 崔 
𣯨	從 毛 
𣯩	毛 㒼 
𣯪	毛 徙 
𣯬	莽 毛 
𣯭	毛 埶 
𣯯	崔 毛 
𣯱	陪 毛 
𣯴	毛 畢 
𣯵	啇 毛 
𣯸	渠 毛 
𣯹	喬 毛 
𣯻	賁 毛 
𣯼	粟 毛 
𣰃	毛 𦓔 
𣰇	毛 矞 
𣰈	毛 幾 
𣰋	𥇛 毛 
𣰌	葛 毛 
𣰕	毛 喿 
𣰘	真 彡 毛 
𣰚	算 毛 
𣰛	蓋 毛 
𣰜	毛 凴 
𣰞	毛 翟 
𣰠	𥈜 毛 
𣰡	囧 囧 毛 
𣰥	毛 蒙 
𣰦	毛 監 
𣰨	賓 毛 
𣰬	毛 賣 
𣰶	襄 毛 
𣰷	毛 韱 
𣰺	皼 毛 
𣰻	雚 毛 
𣰼	毛 聶 
𣰿	麗 毛 
𣱀	毛 羅 
𣱂	變 毛 
𣱈	民 巴 
𣱉	云 民 
𣱍	⺫ 九 氏 
𣱐	氐 垔 
𣱓	𦥯 氐 
𣱗	气 一 力 
𣱜	气 囗 㐅 
𣱦	气 盆 
𣱧	气 重 
𣱫	气 米 田 
𣱳	一 水 
𣱶	氵 卜 
𣱺	水 八 
𣱻	水 几 
𣱼	氵 刀 
𣱽	氵 乃 
𣲀	氵 彡 
𣲂	巛 水 
𣲄	氵 乆 
𣲊	⺊ ⺄ 水 
𣲋	氵 夊 
𣲑	氵 𢆰 
𣲒	氵 仂 
𣲓	氵 龰 
𣲖	氵 𤓰 
𣲜	井 水 
𣲝	仌 水 
𣲡	氵 尐 
𣲢	氵 勹 㐅 
𣲶	氵 囗 九 
𣲽	氵 宂 
𣲾	氵 圣 
𣳀	氵 口 十 
𣳃	氵 七 土 
𣳗	水 母 
𣳜	氵 犯 
𣳟	氵 疋 
𣳠	氵 母 
𣳤	氵 口 土 
𣳦	氵 囟 
𣳩	氵 次 
𣳬	氵 缶 
𣳭	氵 𠬪 
𣳰	氵 木 十 
𣳲	氵 囝 
𣴁	氵 𠂂 
𣴓	氵 件 
𣴖	氵 巛 夕 
𣴞	氵 坌 
𣴟	氵 皃 
𣴢	氵 皁 
𣴣	氵 壯 
𣴥	氵 狂 
𣴨	氵 𦣻 
𣴪	氵 𤰞 
𣴷	氵 抄 
𣴼	氵 㒵 
𣴽	氵 𡵖 
𣵞	氵 吞 
𣵟	氵 大 水 
𣵢	氵 𠯍 
𣵱	氵 抂 
𣵷	氵 邯 
𣵸	氵 竹 几 
𣵺	氵 阝 㐌 
𣵻	氵 陀 
𣵼	氵 盰 
𣵽	氵 芺 
𣶃	氵 𠦝 
𣶆	氵 穹 
𣶈	氵 罔 
𣶊	氵 陌 
𣶋	氵 炙 
𣶌	氵 氏 攵 
𣶍	氵 狀 
𣶏	氵 疌 
𣶐	氵 奅 
𣶘	氵 ⺇ 多 
𣶝	氵 坥 
𣶠	氵 七 𠇍 
𣶡	氵 囗 歺 
𣶣	氵 叀 
𣶤	氵 𫩣 
𣶦	氵 𡇈 
𣶩	氵 画 
𣶫	氵 诣 
𣷞	氵 𣏼 
𣷠	氵 明 
𣷡	氵 忠 
𣷥	氵 𦙚 
𣷩	氵 火 ⺝ 
𣷪	氵 𭖒 
𣷫	氵 放 
𣷶	氵 ⺊ 囗 幺 
𣷾	氵 軌 
𣸀	氵 虺 
𣸃	氵 𦬸 
𣸄	氵 昝 
𣸆	氵 茈 
𣸇	氵 便 
𣸈	氵 叜 
𣸉	氵 𦍒 
𣸋	氵 畎 
𣸎	氵 㕟 
𣸏	氵 拏 
𣸐	水 砅 
𣸒	氵 厗 
𣸘	氵 迱 
𣸙	氵 𠱡 
𣸚	氵 虵 
𣸛	氵 削 
𣸝	氵 𦏺 
𣸠	氵 幺 列 
𣸸	氵 沗 
𣹇	沙 可 
𣹋	氵 鳬 
𣹒	氵 勿 田 
𣹕	氵 律 
𣹚	氵 向 廾 
𣹜	氵 即 
𣹝	氵 陗 
𣹞	氵 冢 
𣹟	氵 貢 
𣹠	氵 冤 
𣹡	氵 耆 
𣹢	氵 圅 
𣹤	氵 挐 
𣹥	氵 倩 
𣹧	氵 窄 
𣹩	氵 脅 
𣹪	氵 旄 
𣹬	𣪊 水 
𣹭	流 水 
𣹮	氵 𣬉 
𣹯	氵 𠣬 
𣹱	氵 欱 
𣹲	氵 屖 
𣹵	氵 山 耴 
𣹶	氵 夎 
𣺀	氵 囗 止 夕 
𣺌	氵 𦕈 
𣺬	氵 荒 
𣺭	氵 戊 丙 
𣺮	氵 套 
𣺰	氵 哨 
𣺳	氵 尸 氺 刂 
𣺹	氵 展 
𣺼	氵 党 
𣺽	氵 罢 
𣻎	氵 𡨥 
𣻐	氵 虘 
𣻑	氵 殺 
𣻒	氵 旍 
𣻕	氵 麻 
𣻖	氵 少 免 
𣻘	氵 梢 
𣻚	氵 術 
𣻛	氵 舂 
𣻜	氵 符 
𣻞	氵 畤 
𣻟	氵 𮍏 
𣻠	氵 斜 
𣻡	氵 莨 
𣻢	氵 通 
𣻣	沝 步 
𣻩	氵 知 ⻏ 
𣻬	氵 𭽀 
𣻮	泉 岀 
𣻱	氵 晝 
𣼚	氵 聃 
𣼞	氵 亻 品 
𣼧	氵 率 
𣼽	氵 朗 
𣽅	氵 聒 
𣽆	氵 筑 
𣽈	氵 𦓔 
𣽌	氵 欿 
𣽍	氵 自 乑 
𣽎	氵 臯 
𣽏	氵 惡 
𣽒	氵 貰 
𣽕	氵 林 厹 
𣽖	氵 牋 
𣽚	氵 戠 
𣽛	氵 答 
𣽝	江 風 
𣽟	氵 款 
𣽡	氵 博 
𣽤	氵 策 
𣽥	氵 頇 
𣽦	氵 𡞣 
𣽨	舟 龹 氺 
𣽫	氵 䓗 
𣽭	氵 𥁰 
𣽮	氵 媱 
𣽯	氵 𨈭 
𣽰	氵 𦨯 
𣽳	氵 兼 几 
𣽴	氵 喟 
𣽷	氵 赐 
𣾤	氵 兓 灬 
𣾦	氵 掌 
𣿅	氵 董 
𣿆	氵 鳧 
𣿇	氵 稔 
𣿈	氵 窣 
𣿉	氵 詣 
𣿊	湅 攵 
𣿌	氵 遏 
𣿎	氵 葴 
𣿐	氵 賊 
𣿒	氵 辠 
𣿓	氵 罪 
𣿝	氵 葑 
𣿞	氵 裏 
𣿟	氵 𰍙 
𣿣	氵 𠜤 皿 
𣿤	氵 占 占 久 
𣿨	氵 觧 
𣿴	氵 𦳝 
𤀃	氵 虍 言 
𤀊	氵 貇 
𤀝	氵 素 ⻏ 
𤀠	氵 熙 
𤀣	氵 暖 
𤀤	氵 算 
𤀦	溂 石 
𤀨	氵 窬 
𤀪	氵 頗 
𤀫	氵 辡 
𤀰	氵 暠 
𤀲	辡 水 
𤀷	津 育 
𤁡	氵 撢 
𤁢	氵 𢧵 
𤁣	氵 罷 
𤁥	氵 輦 
𤁦	溓 瓦 
𤁧	氵 齒 
𤁪	活 頁 
𤁫	氵 八 允 頁 
𤁮	氵 蓲 
𤁯	氵 巤 
𤁰	𣲇 智 
𤁱	氵 蔡 
𤁳	氵 霅 
𤁵	氵 閭 
𤁹	氵 䦝 
𤁼	氵 𥻊 
𤁽	氵 䁝 
𤂀	滿 天 
𤂁	氵 糸 士 冖 牛 
𤂆	氵 孚 虎 
𤂑	氵 辳 
𤂤	氵 大 犇 
𤂲	氵 獚 
𤂶	氵 閵 
𤂷	氵 閼 
𤂺	氵 覧 
𤂼	自 家 水 
𤂿	氵 選 
𤃀	氵 隷 
𤃨	氵 炎 面 
𤃩	氵 霝 
𤃪	氵 戲 
𤃫	氵 薨 
𤃬	氵 𠦝 𠆢 赤 
𤃭	氵 ⺫ 焦 
𤃮	氵 斲 
𤃲	氵 縶 
𤃵	氵 謈 
𤃶	氵 磴 
𤃷	氵 闇 
𤃺	氵 林 畐 
𤃻	刀 畾 水 
𤃼	氵 戊 臣 肉 
𤃽	氵 鮪 
𤄎	氵 鬩 
𤄏	氵 鯀 
𤄑	氵 𣀔 
𤄒	氵 𥳑 
𤄓	氵 藂 
𤄔	氵 𡾃 
𤄖	氵 雜 
𤄘	氵 穴 䀠 夂 
𤄛	氵 魋 
𤄜	氵 䊩 
𤄥	沓 㬎 
𤄧	浿 䚻 
𤄫	氵 旛 
𤄬	氵 雞 
𤄶	氵 藥 
𤄷	氵 羅 
𤄺	氵 邊 
𤄽	氵 璽 
𤅊	氵 獻 
𤅎	氵 顢 
𤅐	氵 豈 豈 
𤅑	氵 壤 
𤅒	氵 雨 叅 
𤅤	氵 镾 
𤅦	氵 𪉷 
𤅩	漢 鳥 
𤅱	氵 蠱 
𤅲	氵 竹 旲 馬 
𤅸	氵 鹽 
𤅹	氵 𡚤 
𤆀	氵 驫 
𤆂	火 一 
𤆄	乃 火 
𤆌	火 又 
𤆍	大 火 
𤆏	火 亏 
𤆑	火 川 
𤆒	丿 了 灬 
𤆕	刃 灬 
𤆜	火 三 
𤆝	火 攴 
𤆞	火 勿 
𤆡	火 乌 
𤆤	火 冗 
𤆬	毛 灬 
𤆮	火 夫 
𤆰	木 火 
𤆳	火 𠕀 
𤆴	𠫓 火 
𤆵	火 巴 
𤆶	火 分 
𤆺	火 孔 
𤆼	火 宁 
𤆾	火 𡰥 
𤇄	火 门 人 
𤇏	氶 灬 
𤇜	火 民 
𤇞	加 火 
𤇠	乎 灬 
𤇮	火 乏 
𤇯	衣 火 
𤇰	伐 火 
𤇳	火 戌 
𤇴	𦣝 灬 
𤇶	火 丞 
𤇾	炏 冖 
𤈄	火 吉 
𤈔	土 弓 灬 
𤈙	火 夷 
𤈦	火 尾 
𤈧	火 役 
𤈫	尸 二 火 又 
𤈶	火 员 
𤈷	火 佥 
𤉌	利 火 
𤉍	火 牢 
𤉎	劭 火 
𤉏	目 力 灬 
𤉙	火 君 
𤉤	火 㡀 
𤉥	𤈕 刂 
𤉦	火 委 
𤉧	㐅 㐅 火 攵 
𤉨	或 火 
𤉪	火 於 
𤉫	火 戈 天 
𤊲	火 𡿺 
𤊴	火 砉 
𤊵	火 卽 
𤊶	火 剌 
𤊻	火 冒 
𤊼	炎 甘 
𤊽	𡗜 炅 
𤊾	卝 目 火 
𤊿	火 臿 
𤋂	𦭝 火 
𤋏	火 娄 
𤋠	火 爫 ⺫ 
𤋨	火 左 丑 
𤋫	火 𡷈 
𤋭	火 香 
𤋮	巸 灬 
𤋰	里 力 灬 
𤌇	𦣞 巳 火 
𤌊	宰 灬 
𤌋	火 鬼 
𤌌	𤇾 井 
𤌍	火 隺 
𤌎	𨳌 火 
𤌏	火 翁 
𤌐	火 圅 
𤌔	肉 犬 灬 
𤌷	火 恚 
𤌹	倝 火 
𤌾	高 火 
𤌿	火 疾 
𤍀	炏 向 
𤍁	殺 灬 
𤍐	推 火 
𤍒	火 巢 
𤍓	野 火 
𤍕	木 酉 火 
𤍖	火 斬 
𤍜	火 參 
𤍠	執 灬 
𤍤	火 章 
𤍽	埶 火 
𤎄	火 焉 
𤎅	敖 火 
𤎋	火 羽 夲 
𤎗	艹 厂 句 灬 
𤎘	刀 𤋁 
𤎣	火 菴 
𤎤	勞 少 
𤎥	帛 炎 
𤎧	𠷎 火 
𤎭	炎 㐭 
𤎯	曾 火 
𤎱	火 雋 
𤎲	火 量 
𤏗	火 森 
𤏘	火 惑 
𤏜	爲 火 
𤏰	火 敝 
𤏱	火 菆 
𤏲	火 着 
𤏶	火 麀 
𤏸	火 著 
𤏻	火 辛 火 又 
𤏽	火 𦍌 辛 
𤏿	臤 目 火 
𤐀	火 畺 
𤐔	炏 是 
𤐙	火 辟 
𤐣	火 鼎 
𤐩	火 蓋 
𤐰	火 蒦 
𤐱	㼲 火 
𤐲	火 𮲡 手 
𤐸	稫 灬 
𤑃	炙 兼 
𤑄	賏 灬 
𤑓	𤎭 乞 
𤑕	火 熏 力 
𤑗	炙 巢 
𤑣	火 丙 丙 丙 
𤑦	火 適 
𤑳	火 蕭 
𤑷	火 閹 
𤑸	火 覧 
𤑹	災 睪 
𤑿	火 聮 
𤒅	火 ? 
𤒓	𢨋 火 
𤒔	火 縛 
𤒕	澡 灬 
𤒘	火 䉣 
𤒝	自 家 火 
𤒦	火 斂 
𤒻	火 闒 
𤓌	火 難 
𤓔	火 燚 大 
𤓕	𦥑 同 炎 
𤓚	火 𦏁 灬 
𤓤	處 處 火 
𤓦	火 𧅌 
𤓪	雥 火 
𤓵	爪 夕 
𤓿	𠬪 巳 
𤔀	爪 奴 
𤔉	爪 田 
𤔋	爪 巨 
𤔌	爫 ⺕ 工 
𤔔	𠬪 龴 禸 又 
𤔖	果 爪 
𤔚	戶 水 爪 
𤔝	禺 爪 
𤔟	文 布 爪 
𤔣	爫 叟 
𤔨	麻 爪 
𤔫	爫 曼 
𤔱	舀 曲 
𤔶	爪 當 
𤕀	爫 幺 幺 幺 安 
𤕄	舀 日 几 日 
𤕊	爪 舋 
𤕒	父 可 
𤕓	父 邪 
𤕘	父 屾 夂 
𤕚	亠 隹 父 
𤕛	父 ⺶ 九 手 
𤕝	㐅 㐅 攴 
𤕞	爻 宁 
𤕟	爻 疋 
𤕢	爻 攵 女 
𤕤	圥 㸚 
𤕬	爿 一 
𤕭	爿 又 
𤕯	爿 水 
𤕷	爿 兆 
𤕽	爿 釆 
𤕾	爿 求 
𤖀	爿 夆 
𤖅	爿 𱼀 水 
𤖆	爿 戔 
𤖇	爿 果 
𤖒	爿 桑 
𤖓	爿 責 
𤖖	爿 黃 
𤖗	爿 歰 
𤖘	爿 賁 
𤖛	將 旦 
𤖝	爿 詹 
𤖞	爿 戢 
𤖟	爿 𡰪 𨐋 
𤖢	爿 歷 
𤖦	爿 靈 
𤖪	片 也 
𤖬	片 殳 
𤖭	片 分 
𤖮	片 勾 
𤖱	片 禾 
𤖳	片 平 
𤖵	片 句 
𤖷	片 皮 
𤖺	片 列 
𤖻	片 多 
𤖼	片 𠂢 
𤖽	片 向 
𤖿	片 亻 氏 
𤗀	片 良 
𤗁	片 足 
𤗃	片 甫 
𤗇	片 空 
𤗈	片 妾 
𤗍	片 宛 
𤗎	片 奄 
𤗏	片 咅 
𤗓	片 承 
𤗘	片 是 
𤗙	片 㡿 
𤗚	片 畐 
𤗛	片 柬 
𤗜	片 叚 
𤗞	片 亭 
𤗨	片 習 
𤗪	片 率 
𤗫	片 离 
𤗬	片 婁 
𤗭	片 虖 
𤗯	片 崔 
𤗳	片 發 
𤗴	片 貴 
𤗵	片 菐 
𤗷	片 粦 
𤗸	片 賁 
𤗺	片 辟 
𤗻	片 詹 
𤗾	片 當 
𤗿	片 臺 
𤘀	片 壽 
𤘃	片 歷 
𤘇	牙 占 
𤘊	牙 邠 
𤘌	牙 奇 
𤘐	牙 禹 
𤘔	一 牛 
𤘖	牜 丁 
𤘘	牜 口 
𤘜	牜 尤 
𤘝	分 牛 
𤘟	牜 冄 
𤘠	牜 天 
𤘡	牜 今 
𤘢	牜 不 
𤘣	牜 冘 
𤘤	比 牛 
𤘦	牜 介 
𤘲	牜 犬 
𤘵	日 牛 
𤘶	牜 手 
𤘷	牜 𠘬 
𤘸	牜 𠬢 
𤘹	牜 丕 
𤘺	牜 宂 
𤘻	牜 𰃦 人 
𤘽	牜 句 
𤘾	牜 平 
𤙅	牜 布 
𤙇	牜 甲 
𤙋	么 冖 牛 
𤙌	牜 尼 
𤙎	牜 皮 
𤙏	去 牛 
𤙒	牜 劦 
𤙔	牜 兆 
𤙕	牜 虫 
𤙖	合 牛 
𤙘	收 牛 
𤙛	牜 余 
𤙝	牜 邑 
𤙞	牜 坒 
𤙟	初 牛 
𤙡	牜 辛 
𤙣	含 牛 
𤙤	牜 孚 
𤙩	牜 每 
𤙭	牜 甫 
𤙯	牜 劳 
𤙰	牜 㝵 
𤙱	牜 舍 
𤙴	牜 卓 
𤙵	牜 隹 
𤙼	有 力 牛 
𤙽	牜 尚 
𤙾	牜 幷 
𤚀	牜 采 
𤚉	取 牛 
𤚊	牜 𣏋 
𤚍	牜 蚩 
𤚎	牜 俞 
𤚏	牜 重 
𤚓	牧 厂 文 
𤚔	牜 叜 
𤚚	牜 毒 
𤚜	止 小 又 牛 
𤚝	牜 皇 
𤚟	牜 待 
𤚡	牜 度 
𤚢	牜 帝 
𤚣	牜 宀 圭 
𤚤	牜 眉 
𤚨	牜 辰 又 
𤚩	牜 秦 
𤚪	牜 𣬉 
𤚫	牜 唐 
𤚬	牜 倉 
𤚭	牜 䍃 
𤚯	牜 臭 
𤚰	牜 旁 
𤚱	牜 骨 
𤚵	牜 㐬 口 
𤚼	𣪊 牛 
𤚽	牜 尃 
𤛁	牜 昷 
𤛄	牜 斊 
𤛊	牜 習 
𤛍	牜 崔 
𤛎	敏 牛 
𤛏	牜 虘 
𤛑	牜 庸 
𤛖	赤 殳 牛 
𤛗	殸 牛 
𤛘	牜 莽 
𤛙	丨 目 干 牟 
𤛚	牪 豕 
𤛛	牜 脩 
𤛜	𤚖 刂 
𤛝	宿 牛 
𤛟	牜 𤰈 
𤛢	牜 曾 
𤛣	牜 翕 
𤛥	牜 黃 
𤛦	牜 厥 
𤛧	牜 尋 
𤛪	牜 老 老 
𤛬	牜 買 
𤛮	牜 勞 
𤛱	𦥯 牛 
𤛲	牜 嵬 
𤛷	牜 嗇 
𤛻	牜 蔵 
𤛿	𪏯 牛 
𤜁	牟 感 
𤜂	衞 牛 
𤜄	牜 褱 
𤜇	牜 毚 
𤜉	牜 嬰 
𤜊	牜 哥 言 
𤜋	牜 鬼 言 
𤜍	牜 雚 
𤜔	日 幸 匊 牛 
𤜕	士 冖 牛 覀 相 
𤜖	牜 纍 
𤜘	魔 牛 
𤜙	牜 靈 
𤜜	犭 力 
𤜝	犭 几 
𤜡	犭 ⻏ 
𤜢	犭 卂 
𤜣	犭 也 
𤜤	犭 乇 
𤜧	巾 犬 
𤜫	犭 叉 
𤜯	犭 及 
𤜰	犭 今 
𤜱	犭 巴 
𤜲	巿 犬 
𤜵	犭 开 
𤜹	犬 欠 
𤜻	犭 比 
𤜼	犭 勻 
𤜾	犭 丮 
𤝂	犭 𣎳 
𤝄	犭 毛 
𤝅	犭 公 
𤝈	犭 殳 
𤝉	犭 予 
𤝍	犭 日 
𤝎	犭 水 
𤝐	犭 号 
𤝒	犭 出 
𤝓	犭 占 
𤝔	犭 付 
𤝕	犭 母 
𤝖	犭 只 
𤝘	犭 乎 
𤝚	犭 申 
𤝛	犭 它 
𤝞	犭 术 
𤝟	弗 犬 
𤝧	犭 亻 勺 
𤝬	犭 氐 
𤝭	犭 此 
𤝮	𠂔 犬 
𤝯	犭 伏 
𤝰	犭 合 
𤝱	犭 因 
𤝳	犭 伊 
𤝷	犭 夅 
𤝸	犭 米 
𤝹	犭 朱 
𤝻	犭 多 
𤝼	犭 自 
𤝽	犭 聿 
𤝿	犭 匡 
𤞂	犭 至 
𤞇	犭 圭 
𤞈	犭 一 丘 
𤞉	犭 戍 
𤞊	犭 列 
𤞋	犭 早 
𤞌	犭 宅 
𤞏	犭 西 
𤞗	犭 件 
𤞚	犭 肖 
𤞛	壯 犬 
𤞞	犭 谷 
𤞟	犭 豆 
𤞡	犭 邪 
𤞢	犭 ⺸ 
𤞣	肙 犬 
𤞤	犭 严 
𤞥	犭 呆 
𤞮	穴 㐅 犬 
𤞰	犭 求 
𤞲	犭 孚 
𤞳	犭 𠯑 
𤞴	犭 角 
𤞶	犭 罕 
𤞿	犴 犬 
𤟀	皂 犬 
𤟃	犭 疌 
𤟅	犭 臽 
𤟆	犭 剎 
𤟇	犭 炎 
𤟉	犭 岸 
𤟌	爿 𱼀 犬 
𤟍	犭 易 
𤟎	犭 屈 
𤟑	犭 戾 
𤟓	䒥 犬 
𤟖	犭 采 
𤟘	犭 录 
𤟚	犭 臼 又 
𤟝	犭 𧆞 
𤟞	交 口 犬 
𤟟	犭 音 
𤟢	盾 犬 
𤟣	犭 盈 
𤟤	犭 軍 
𤟥	犭 是 
𤟦	犭 耎 
𤟧	犭 思 
𤟪	犭 突 
𤟷	犭 歪 
𤟸	犭 申 攵 
𤟹	犭 禺 
𤟼	犭 訇 
𤟾	犭 帝 
𤟿	犭 宣 
𤠀	犭 凾 
𤠇	犭 革 
𤠋	犭 娄 
𤠌	犭 柴 
𤠍	犭 般 
𤠎	犭 畟 
𤠏	犭 𱐔 止 
𤠐	犭 𦐇 
𤠓	犭 奚 
𤠖	犭 高 
𤠘	犭 蚤 
𤠙	犭 哥 
𤠚	犭 素 
𤠛	犭 𮎰 
𤠝	犭 差 
𤠟	犭 荅 
𤠠	犭 衰 
𤠪	巛 囯 犬 
𤠫	犭 栗 
𤠭	犭 射 
𤠯	犭 唐 
𤠶	犭 真 
𤠺	犭 畢 
𤠼	殻 犬 
𤠽	犭 戚 
𤠿	犭 堅 
𤡂	犭 累 
𤡃	犭 欶 
𤡆	犭 從 
𤡇	犭 毫 
𤡏	犭 镸 攵 
𤡐	犭 曹 
𤡓	犭 國 
𤡔	犭 梟 
𤡕	犭 鳥 
𤡖	犭 這 
𤡝	犭 非 土 
𤡟	犭 患 
𤡡	犭 臼 匃 
𤡢	犭 离 
𤡣	犭 虛 
𤡤	犭 𦓔 
𤡥	犭 閒 
𤡧	犭 惢 
𤡨	犭 絲 
𤡪	犭 隋 
𤡬	犭 壹 
𤡭	犭 彭 
𤡮	犭 然 
𤡯	犭 舃 
𤡰	犭 斑 
𤡱	犭 貴 
𤡲	犭 開 
𤡳	犭 東 攵 
𤡾	惡 犬 
𤡿	答 犬 
𤢀	犭 喜 
𤢁	犭 艹 丳 
𤢂	犭 粟 
𤢄	犭 敞 
𤢊	犭 路 
𤢋	犭 歹 攵 丗 
𤢎	犭 當 
𤢏	犭 亶 
𤢐	犭 雍 
𤢒	犭 廌 
𤢓	犭 豦 
𤢕	睪 犬 
𤢖	犭 喿 
𤢗	犭 雷 
𤢘	犭 夂 素 
𤢟	犭 睪 
𤢣	犭 辟 
𤢦	犭 㥯 
𤢨	犭 蒿 
𤢪	犭 巤 
𤢭	犭 豪 
𤢮	犭 羊 犬 犬 
𤢴	犭 樂 
𤢵	犭 厲 
𤢶	犭 窮 
𤢹	犭 畾 
𤢺	犭 頡 
𤢼	犭 適 
𤣃	犭 魯 
𤣅	霍 犬 
𤣆	犭 聮 
𤣌	犭 學 
𤣎	犭 嬰 
𤣑	犭 巂 
𤣔	犭 爾 王 
𤣖	犭 ? 
𤣘	冥 犭 者 
𤣞	犭 黨 
𤣟	犭 覽 
𤣠	犭 嚻 
𤣨	玄 曷 
𤣬	九 玉 
𤣮	𤣩 乞 
𤣯	𤣩 乇 
𤣰	𤣩 土 
𤣱	𤣩 已 
𤣲	𤣩 卂 
𤣵	𤣩 么 
𤣶	玉 山 
𤣸	𤣩 丈 
𤣹	𤣩 尹 
𤣼	內 玉 
𤤊	𤣩 刀 刀 
𤤋	夭 玉 
𤤐	𤣩 斥 
𤤑	𤣩 卭 
𤤒	𤣩 犮 
𤤦	𤣩 田 
𤤧	𤣩 由 
𤤩	𤣩 㐌 
𤤫	𤣩 外 
𤤬	𤣩 幼 
𤤮	𤣩 冬 
𤤱	𤣩 𠬦 
𤤲	𤣩 工 几 
𤤷	𤣩 𠂤 
𤤸	𤣩 朵 
𤤺	𤣩 曳 
𤥎	𤣩 𤆌 
𤥒	𤣩 西 
𤥓	合 玉 
𤥔	夙 玉 
𤥗	𤣩 丣 
𤥭	𤣩 車 
𤥮	𤣩 少 口 
𤥰	𤣩 皃 
𤥷	㺳 土 
𤥻	𤣩 延 
𤥽	𤣩 於 
𤥿	𤣩 夜 
𤦀	弓 尔 玉 
𤦃	來 玉 
𤦄	𤣩 巛 电 
𤦤	𤣩 兒 
𤦦	玢 王 
𤦪	𤣩 東 
𤦮	𤣩 治 
𤦺	𤣩 竒 
𤧕	𤣩 垔 
𤧘	𤣩 香 
𤧙	𤣩 臾 
𤧚	𤣩 怱 
𤧠	玉 土 虫 
𤧣	𤣩 建 
𤧩	𥄗 玉 
𤧫	𤣩 追 
𤧭	𤣩 旁 
𤨍	玨 冖 𠠴 
𤨎	𤣩 家 
𤨏	𤣩 𧴲 
𤨐	舀 玉 
𤨑	𤣩 荅 
𤨖	𤣩 扈 
𤨗	卣 木 玉 
𤨙	勒 玉 
𤨶	𤣩 㳟 
𤨻	士 冖 吅 王 
𤩂	𤣩 勞 
𤩄	𤣩 巽 
𤩨	𤣩 叅 
𤩩	王 号 虍 一 
𤩪	𤣩 象 
𤩭	𤣩 號 
𤩰	𤣩 㮚 
𤩱	殿 玉 
𤩲	𤣩 葛 
𤪄	𤣩 罨 
𤪆	𤣩 𦘒 冖 牟 
𤪌	𤣩 綦 
𤪍	𤣩 舝 
𤪎	𣣸 玉 
𤪞	𤣩 爫 冖 目 夊 
𤪡	君 君 玉 
𤪪	𤣩 篆 
𤪮	𤣩 廛 
𤫊	霝 王 
𤫕	𤣩 夒 
𤫝	王 廿 口 十 𭥭 
𤫞	𤣩 寳 
𤫣	𤣩 甗 
𤫧	𤣩 𦭝 大 韭 
𤫨	𤣩 兟 鬲 
𤫩	𤣩 靈 
𤫫	分 瓜 
𤫬	瓜 丰 
𤫱	句 瓜 
𤫲	令 瓜 
𤫵	瓜 ⾆ 
𤫶	吉 瓜 
𤫷	朿 瓜 
𤫹	六 𠆢 瓜 
𤫺	瓜 系 
𤫻	步 瓜 
𤬁	果 瓜 
𤬂	叔 瓜 
𤬃	咅 瓜 
𤬌	彖 瓜 
𤬏	婁 瓜 
𤬐	𤇾 瓜 
𤬓	兼 瓜 
𤬔	瓜 䍃 
𤬕	瓜 氏 口 𫶧 
𤬖	𱼀 系 瓜 
𤬘	䖒 瓜 
𤬛	盧 瓜 
𤬝	鬳 瓜 
𤬠	瓜 雚 
𤬥	亠 吅 習 瓜 衣 
𤬦	冖 瓦 
𤬧	瓦 十 
𤬨	瓦 凡 
𤬩	弋 瓦 
𤬪	土 瓦 
𤬫	瓦 卂 
𤬭	不 瓦 
𤬯	瓦 今 
𤬱	瓦 勿 
𤬳	工 几 瓦 
𤬵	氐 瓦 
𤬷	出 瓦 
𤬾	朵 瓦 
𤬿	圭 瓦 
𤭂	舟 瓦 
𤭈	兆 瓦 
𤭉	亡 巛 瓦 
𤭌	弟 瓦 
𤭍	瓦 白 八 
𤭑	吾 瓦 
𤭒	良 瓦 
𤭔	車 瓦 
𤭙	瓦 含 
𤭛	岡 瓦 
𤭜	𥝢 瓦 
𤭞	享 瓦 
𤭟	阜 瓦 
𤭠	臤 瓦 
𤭧	皆 瓦 
𤭩	声 厶 瓦 
𤭫	革 瓦 
𤭬	缸 瓦 
𤭰	秌 瓦 
𤭱	胡 瓦 
𤭴	枼 瓦 
𤭻	哥 瓦 
𤭼	𦐇 瓦 
𤭽	祟 瓦 
𤮆	虍 业 瓦 
𤮊	康 瓦 
𤮋	國 瓦 
𤮌	瓦 接 
𤮍	瓦 專 
𤮎	絫 瓦 
𤮏	黃 瓦 
𤮐	尊 瓦 
𤮕	敝 瓦 
𤮘	豋 瓦 
𤮙	䖒 瓦 
𤮚	雷 瓦 
𤮜	亶 瓦 
𤮧	盧 瓦 
𤮩	亯 从 干 瓦 
𤮪	㼱 灷 
𤮭	毚 瓦 
𤮯	崔 臼 瓦 
𤮰	巂 瓦 
𤮱	聶 瓦 
𤮳	瓦 雚 
𤮷	𩅸 瓦 
𤮸	𩆞 瓦 
𤮼	弋 甘 
𤮽	甘 干 
𤯄	甘 氏 
𤯇	甘 炎 
𤯌	麻 甘 
𤯐	甘 閻 
𤯖	乆 生 
𤯚	不 生 
𤯜	生 力 力 
𤯡	生 朿 
𤯥	如 生 
𤯷	舜 生 
𤯸	生 筋 
𤯻	生 蒙 
𤰂	生 襄 
𤰅	夂 用 
𤰈	𬜠 用 
𤰑	𠫓 口 月 凡 龷 用 
𤰙	九 田 
𤰚	九 田 
𤰝	田 巛 
𤰟	田 干 
𤰠	田 干 
𤰡	亡 田 
𤰦	田 乇 
𤰪	田 分 
𤰬	田 少 
𤰳	天 田 
𤱃	田 木 
𤱅	田 内 
𤱆	田 𠕀 
𤱇	父 田 
𤱋	甲 冄 
𤱌	田 且 
𤱍	田 皮 
𤱎	田 幼 
𤱐	田 疋 
𤱔	亠 田 么 
𤱛	田 禾 
𤱜	禾 田 
𤱝	田 𠆢 工 
𤱟	田 出 
𤱠	田 召 
𤱡	龴 田 也 
𤱣	冉 甲 
𤱧	田 朵 
𤱨	田 共 
𤱩	田 兆 
𤱴	田 乍 一 
𤱵	龹 田 
𤱷	田 劦 
𤱸	厶 水 田 
𤱹	𡿧 田 丁 
𤱺	共 田 
𤱽	甾 夫 
𤱾	甾 夬 
𤲉	田 大 日 
𤲑	甾 宁 
𤲓	田 來 
𤲕	田 侖 
𤲖	田 忝 
𤲗	臤 田 
𤲚	田 東 
𤲨	田 卷 
𤲩	田 炎 
𤲬	田 耎 
𤲭	田 木 田 
𤲰	甲 冒 
𤲸	兹 田 
𤲺	田 奚 
𤳂	田 秝 
𤳃	由 奚 
𤳊	甾 幷 
𤳎	田 責 
𤳓	列 異 
𤳕	粥 田 
𤳖	番 去 
𤳘	申 登 
𤳝	田 秝 刂 
𤳠	田 ⺊ 日 旬 
𤳤	甾 奚 
𤳥	田 田 林 
𤳦	畾 大 
𤳪	厭 田 
𤳭	田 田 龶 夗 
𤳯	甾 庶 
𤳴	田 田 可 可 
𤴀	田 田 堯 
𤴄	𤳳 大 
𤴍	疊 宁 
𤴒	𤳳 囘 鳥 
𤴓	一 龰 
𤴙	囪 疋 
𤴛	叀 龰 
𤴟	帶 疋 
𤴢	執 疋 
𤴣	辟 疋 
𤴥	疒 乙 
𤴦	疒 九 
𤴧	疒 乂 
𤴨	疒 又 
𤴪	疒 几 
𤴯	疒 丸 
𤴱	疒 乇 
𤴻	疒 犬 
𤴼	疒 欠 
𤴽	疒 今 
𤴾	疒 斤 
𤴿	疒 冄 
𤵀	疒 旡 
𤵂	疒 心 
𤵊	疒 屯 
𤵋	疒 𢆰 
𤵎	疒 𠂉 几 
𤵐	疒 勿 
𤵒	疒 文 
𤵘	疒 必 
𤵚	疒 㐌 
𤵛	疒 丕 
𤵝	疒 母 
𤵞	疒 𠆢 土 
𤵟	疒 𠬢 
𤵠	疒 卯 
𤵡	疒 乎 
𤵥	疒 禾 
𤵦	疒 札 
𤵬	疒 犮 
𤵭	疒 甲 
𤵮	疒 丿 火 
𤵯	疒 匕 𫶧 
𤵸	疒 夅 
𤵹	疒 吉 
𤵻	疒 兇 
𤵼	疒 向 
𤵽	疒 艾 
𤵾	疒 宅 
𤶀	疒 交 
𤶁	疒 老 
𤶈	疒 西 
𤶋	疒 色 
𤶓	疒 亠 日 
𤶕	疒 吞 
𤶖	疒 孚 
𤶘	疒 言 
𤶚	疒 圼 
𤶛	疒 邑 
𤶜	疒 壯 
𤶠	疒 余 
𤶤	疒 尔 又 
𤶧	疒 员 
𤶮	病 七 
𤶰	疒 一 血 
𤶱	疒 串 
𤶲	疒 呈 
𤶳	疒 告 
𤶴	疒 身 
𤷀	疒 尪 
𤷁	疒 不 土 
𤷂	疒 肥 
𤷃	疒 戔 
𤷄	疒 卷 
𤷅	疒 兒 
𤷆	疒 東 
𤷇	疒 或 
𤷉	疒 亟 
𤷌	疒 臤 
𤷍	疒 其 
𤷎	疒 阜 
𤷏	疒 㸒 
𤷑	疒 咎 
𤷒	疒 𤰞 
𤷓	疒 欣 
𤷔	疒 侖 
𤷕	疒 采 
𤷖	疒 夌 
𤷗	疒 㡀 
𤷘	疒 卓 
𤷙	疒 㝵 
𤷟	疒 拉 
𤷡	疒 虎 
𤷢	疒 具 
𤷤	疒 肴 
𤷦	疒 京 
𤷹	疒 心 及 
𤷻	疒 𡿺 
𤷼	疒 相 
𤷽	疒 卻 
𤷾	疒 匧 
𤷿	疒 突 
𤸀	疒 胥 
𤸁	疒 彖 
𤸃	疒 叜 
𤸅	疒 昬 
𤸆	疒 韋 
𤸈	疒 酋 
𤸉	疒 㒸 
𤸊	疒 怠 
𤸋	疒 界 
𤸎	疒 曷 
𤸏	疒 柰 
𤸑	疒 复 
𤸒	疒 禺 
𤸓	疒 致 
𤸖	疒 哀 
𤸗	疒 付 犬 
𤸡	疒 英 
𤸤	疒 食 
𤸦	疒 子 子 子 
𤸪	疒 挈 
𤸫	疒 員 
𤸬	疒 衰 
𤸮	疒 屑 
𤸯	疒 桑 
𤸱	疒 盍 
𤸲	疒 烝 
𤸳	疒 豈 
𤸴	疒 索 
𤸵	疒 尃 
𤸷	疒 君 巾 
𤸸	疒 益 
𤸹	疒 剡 
𤸻	疒 拏 
𤸼	疒 烏 
𤹇	疒 秮 
𤹈	疒 林 几 
𤹊	疒 少 虫 
𤹋	疒 禾 民 
𤹌	疒 師 
𤹐	疒 烈 
𤹜	疒 宮 
𤹝	疒 畢 
𤹞	疒 啇 
𤹡	疒 虘 
𤹢	疒 北 而 
𤹣	疒 虖 
𤹤	疒 𣳾 
𤹥	疒 殸 
𤹦	疒 啚 
𤹧	疒 心 皿 丁 
𤹨	疒 連 
𤹩	疒 奞 
𤹯	疒 恿 
𤹲	疒 共 田 
𤹴	痲 女 
𤹵	疒 專 
𤹷	疒 鳥 
𤹸	疒 ⺈ 田 心 
𤺀	疒 立 衣 
𤺃	疒 臯 
𤺄	疒 童 
𤺅	疒 𠭥 
𤺇	疒 徧 
𤺉	疒 為 
𤺊	疒 斯 
𤺌	疒 登 
𤺎	疒 舄 
𤺏	疒 番 
𤺐	疒 猲 
𤺓	疒 敝 
𤺔	疒 貰 
𤺕	疒 費 
𤺖	疒 閔 
𤺘	疒 亞 欠 
𤺪	疒 善 
𤺫	疒 惢 
𤺷	疒 極 
𤺺	疒 亶 
𤺻	疒 雋 
𤺼	疒 翏 力 
𤺾	疒 奧 
𤻂	疒 睪 
𤻃	疒 暑 
𤻄	疒 遂 
𤻅	疒 愛 
𤻆	疒 頑 
𤻇	疒 楚 
𤻌	疒 過 
𤻖	疒 鼻 
𤻘	疒 㥯 
𤻙	疒 蒦 
𤻜	疒 蓋 
𤻝	疒 寧 
𤻢	疒 医 几 口 又 
𤻤	疒 秝 止 
𤻦	疒 息 戈 
𤻱	疒 慮 
𤻲	疒 樂 
𤻶	疒 編 
𤻷	疒 盤 
𤻿	疒 既 木 
𤼀	疒 穌 
𤼁	疒 瞢 
𤼂	疒 憲 
𤼃	疒 龍 
𤼅	疒 器 
𤼋	疒 韱 
𤼌	疒 翼 
𤼍	痳 香 
𤼏	疒 歛 
𤼐	疒 雚 
𤼒	疒 巂 
𤼗	疒 鹿 足 
𤼘	疒 羸 
𤼙	疒 䜌 
𤼚	疒 蠆 
𤼜	痺 虫 虫 
𤼢	疒 歡 
𤼤	疒 𡚤 
𤼮	癶 爫 丂 
𤼵	𤼩 弓 
𤼶	登 力 
𤼺	癶 貝 殳 
𤽁	白 十 
𤽃	白 川 
𤽅	白 兀 
𤽉	白 分 
𤽊	白 比 
𤽌	白 巿 
𤽕	白 丶 兀 
𤽣	必 白 
𤽥	白 各 
𤽦	白 缶 
𤽯	白 寿 
𤽱	白 足 
𤽲	白 男 
𤽳	白 川 日 
𤽹	白 卑 
𤽺	白 彔 
𤽼	白 隹 
𤽿	白 念 
𤾀	白 龶 贝 
𤾄	昋 白 
𤾅	白 非 
𤾈	白 軍 
𤾉	白 昜 
𤾊	𢏚 白 
𤾑	白 一 䒑 甘 
𤾒	白 田 冗 
𤾕	竝 白 
𤾛	白 票 
𤾝	白 麻 
𤾠	白 單 
𤾢	白 登 
𤾣	白 菐 
𤾥	白 曾 
𤾦	白 𠷎 
𤾫	白 翟 
𤾬	白 蒙 
𤾭	皇 書 
𤾲	皇 白 本 
𤾵	白 弊 
𤾺	皇 單 
𤾿	夕 韭 白 兆 
𤿀	白 贊 
𤿄	白 巛 白 巛 白 巛 
𤿅	白 靈 
𤿆	皮 丁 
𤿇	皮 刀 
𤿈	勺 皮 
𤿋	皮 才 
𤿎	比 皮 
𤿏	內 皮 
𤿐	开 皮 
𤿑	尣 皮 
𤿒	皮 內 
𤿓	㐅 㐅 皮 
𤿕	民 皮 
𤿖	末 皮 
𤿗	皮 末 
𤿘	勹 口 皮 
𤿙	此 皮 
𤿚	且 皮 
𤿟	旬 皮 
𤿠	吉 皮 
𤿡	危 皮 
𤿣	山 干 皮 
𤿧	旱 皮 
𤿨	肖 皮 
𤿩	告 皮 
𤿫	兌 皮 
𤿭	皮 甫 
𤿳	臤 皮 
𤿴	彔 皮 
𤿵	叕 皮 
𤿶	典 皮 
𤿷	臽 皮 
𤿼	尚 皮 
𤿽	沓 皮 
𤿾	卑 皮 
𥀁	者 皮 
𥀂	封 皮 
𥀃	侯 皮 
𥀈	臿 皮 
𥀉	𠚏 皮 
𥀎	𣪊 皮 
𥀏	𰗣 皮 
𥀓	留 皮 
𥀔	鹿 皮 
𥀖	皮 𠀐 回 
𥀘	羽 皮 皮 
𥀙	肉 皮 皮 
𥀛	皮 曹 
𥀝	皮 宿 
𥀠	皮 貴 
𥀣	𦥯 皮 
𥀥	葛 皮 
𥀫	需 皮 
𥀬	厭 皮 
𥀭	皮 需 
𥀮	月 巛 囪 皮 
𥀰	巤 皮 
𥀱	廣 皮 
𥀲	皮 賣 
𥀵	盧 皮 
𥀹	繭 皮 
𥀺	䜌 皮 
𥀻	皷 戚 
𥀾	皷 嚮 
𥁁	工 皿 
𥁂	孑 皿 
𥁃	亡 皿 
𥁆	牙 皿 
𥁇	斗 皿 
𥁎	用 皿 
𥁐	台 皿 
𥁑	必 皿 
𥁒	幼 皿 
𥁕	囚 皿 
𥁟	列 皿 
𥁠	龹 皿 
𥁡	污 皿 
𥁢	乔 皿 
𥁮	攸 皿 
𥁯	足 皿 
𥁲	沙 皿 
𥁵	沖 皿 
𥁸	卷 皿 
𥁹	林 皿 
𥂁	𬐚 土 
𥂂	矛 𠚣 皿 
𥂃	𢓤 皿 
𥂋	涂 皿 
𥂒	厶 𦥔 皿 
𥂓	麻 皿 
𥂙	奞 皿 
𥂢	敖 皿 
𥂣	郭 皿 
𥂤	𦥑 古 皿 
𥂥	歺 戔 皿 
𥂦	敦 皿 
𥂧	酉 右 皿 
𥂨	羽 盒 
𥂰	酤 皿 
𥂵	𣸁 皿 
𥂸	楊 皿 
𥃀	亠 肉 㘝 皿 
𥃌	辛 來 皿 
𥃔	𦥑 水 臼 皿 
𥃕	壺 盍 
𥃟	殸 亼 吅 皿 
𥃠	魯 益 
𥃤	目 ⺃ 
𥃧	目 丩 
𥃨	目 卜 
𥃩	目 匕 
𥃪	目 十 
𥃫	目 又 
𥃮	入 目 
𥃯	目 几 
𥃰	亠 目 
𥃴	目 卂 
𥃵	目 凡 
𥃸	目 也 
𥃹	目 川 
𥃺	目 兀 
𥃽	目 工 
𥃾	目 土 
𥃿	目 工 
𥄁	𠃊 目 乂 
𥄇	氏 目 
𥄈	六 目 
𥄉	𠃊 目 巛 
𥄋	目 內 
𥄍	目 介 
𥄎	目 攴 
𥄑	目 夫 
𥄒	目 化 
𥄓	不 目 
𥄔	目 巿 
𥄕	卝 目 
𥄖	目 𰅭 
𥄗	目 㕚 
𥄘	八 ⺈ 目 
𥄛	目 予 
𥄜	目 𠫘 
𥄝	目 一 山 
𥄢	目 木 
𥄦	目 亢 
𥄱	弗 目 
𥄲	⺫ 目 
𥄴	目 穴 
𥄵	目 术 
𥄶	目 司 
𥄷	目 巨 
𥄸	目 卯 
𥄹	目 包 
𥄻	目 它 
𥄼	目 瓜 
𥄿	目 𡰥 
𥅁	目 乍 
𥅄	奴 目 
𥅑	目 㠯 
𥅒	目 𠙻 
𥅓	目 㐌 
𥅔	目 丘 
𥅗	目 皮 
𥅘	目 尔 
𥅞	目 式 
𥅟	目 交 
𥅠	目 后 
𥅡	目 而 
𥅦	目 耒 
𥅧	目 血 
𥅨	目 亘 
𥅪	目 收 
𥅬	目 勹 云 
𥅴	目 夹 
𥅵	止 八 目 
𥅷	少 亠 目 
𥅺	目 色 
𥅻	目 充 
𥅽	合 目 
𥆅	吉 目 
𥆆	目 𠫔 𫶧 
𥆌	目 角 
𥆑	目 廷 
𥆔	目 孝 
𥆖	目 豆 
𥆘	目 貝 
𥆙	目 尨 
𥆚	目 汪 
𥆛	役 目 
𥆜	目 往 
𥆝	沙 目 
𥆟	目 兌 
𥆡	目 含 
𥆣	䀠 又 
𥆥	目 走 
𥆦	目 兀 王 
𥆧	目 闰 
𥆯	目 坒 
𥆲	目 𡵶 
𥆳	𠦑 目 
𥆶	目 义 手 
𥆸	目 女 夬 
𥇄	目 又 目 
𥇆	目 𠃊 米 
𥇇	目 沙 
𥇉	目 羌 
𥇌	目 臽 
𥇍	目 卓 
𥇎	目 弓 尔 
𥇏	目 炅 
𥇑	目 兩 
𥇒	目 妾 
𥇓	目 定 
𥇔	目 長 
𥇕	目 制 
𥇖	非 目 
𥇗	目 尸 由 
𥇘	目 囷 
𥇙	或 目 
𥇚	目 奇 
𥇛	大 䀠 
𥇜	目 享 
𥇞	目 占 土 
𥇟	目 効 
𥇠	夂 䀠 
𥇢	目 斩 
𥇭	目 知 
𥇯	目 勿 勿 
𥇰	目 忽 
𥇱	目 𣏋 
𥇲	波 目 
𥇳	目 帚 
𥇿	目 或 
𥈂	目 亟 
𥈄	巷 目 
𥈆	目 冒 
𥈇	目 耎 
𥈈	目 句 灬 
𥈉	目 奐 
𥈊	目 臿 
𥈋	目 禹 
𥈏	䀠 夭 
𥈑	目 矦 
𥈒	目 𢇂 
𥈓	目 咼 
𥈕	目 㿽 
𥈖	目 羍 
𥈗	目 頁 
𥈙	目 剌 
𥈚	目 辶 庂 
𥈛	目 六 目 
𥈟	目 叜 
𥈬	目 禺 
𥈻	目 共 土 
𥈼	般 目 
𥈽	𡨄 目 
𥈾	目 窅 
𥈿	目 貢 
𥉀	目 𥄳 
𥉁	䀠 夰 
𥉃	能 目 
𥉄	目 骨 
𥉅	目 鬲 
𥉆	上 示 又 目 
𥉇	目 冓 
𥉈	目 脩 
𥉊	目 馬 
𥉋	目 𣳾 
𥉌	目 荅 
𥉐	目 奚 
𥉑	目 隺 
𥉒	目 臬 
𥉓	目 𥁑 
𥉔	耿 目 
𥉕	目 冡 
𥉖	目 恚 
𥉙	目 耆 
𥉜	目 秦 
𥉝	目 𠁁 
𥉟	目 般 
𥉰	目 舀 
𥉳	目 留 
𥉴	目 密 
𥉵	麻 目 
𥉶	目 鹿 
𥉷	目 戚 
𥉸	目 堅 
𥉺	目 窒 
𥉻	目 祭 
𥉼	目 梟 
𥉽	目 康 
𥉾	目 翏 
𥉿	目 不 見 
𥊀	目 參 
𥊇	臣 𠂉 二 目 
𥊈	目 梨 
𥊉	目 穴 合 
𥊊	目 卉 八 𠆢 十 
𥊌	目 剿 
𥊑	目 曼 
𥊒	目 逢 
𥊓	目 產 
𥊔	目 商 
𥊧	殸 目 
𥊪	目 爲 
𥊫	目 貫 
𥊬	目 戢 
𥊭	目 尊 
𥊮	目 畫 
𥊯	目 絜 
𥊴	目 最 
𥊶	目 然 
𥊸	目 𢛳 
𥊽	𥄳 弟 
𥊾	工 目 頁 
𥊿	䀠 ⺫ 又 
𥋁	䀠 冖 电 
𥋌	目 散 
𥋎	目 睂 
𥋙	目 業 
𥋚	卝 ⺫ 戈 目 
𥋛	目 蜀 
𥋜	眉 穴 八 又 
𥋝	目 黽 
𥋟	目 義 
𥋡	䀠 冖 弜 
𥋣	目 賈 
𥋤	尚 甘 目 
𥋥	䀠 兔 
𥋿	目 赫 
𥌀	目 察 
𥌁	目 㬎 
𥌂	䀠 穴 方 
𥌃	目 爾 
𥌅	厭 目 
𥌆	目 壽 
𥌈	目 監 
𥌊	辡 目 
𥌍	目 六 隻 
𥌏	眉 冥 
𥌐	目 留 心 
𥌚	目 賣 
𥌛	目 黎 
𥌞	目 樊 
𥌟	上 矢 余 目 
𥌤	目 𨽻 
𥌨	目 頪 
𥌩	目 德 
𥌪	目 𥈜 
𥌮	目 歷 
𥌰	目 遺 
𥌺	目 龠 
𥌻	目 闌 
𥌼	目 霝 
𥌽	目 嬰 
𥌾	目 應 
𥌿	目 隸 
𥍀	目 韱 
𥍁	歸 目 
𥍅	入 入 龷 龷 𠆢 盰 
𥍆	目 燮 
𥍉	目 聶 
𥍋	目 巂 
𥍓	目 嚴 
𥍔	目 纍 
𥍚	目 變 
𥍝	矛 一 
𥍞	矛 刃 
𥍟	矛 殳 
𥍣	矛 号 
𥍨	矛 危 
𥍪	矛 豸 
𥍫	矛 良 
𥍬	矛 夋 
𥍭	矛 折 
𥍮	矛 夆 
𥍱	矛 告 
𥍲	柔 內 
𥍳	柔 丑 
𥍴	矛 易 
𥍷	矛 怱 
𥍸	矛 施 
𥍹	矛 建 
𥍺	矛 㚇 
𥍻	矛 匽 
𥍼	矛 英 
𥎀	矛 頁 
𥎂	矛 茸 
𥎃	矛 氣 
𥎅	矛 𥄳 
𥎆	矛 害 
𥎈	矛 夂 酉 
𥎊	矛 堇 
𥎍	矛 責 
𥎎	矛 解 
𥎐	矞 出 
𥎑	矛 朁 
𥎒	矛 明 心 
𥎓	矛 豊 
𥎔	矛 豕 虫 
𥎕	矞 戍 
𥎖	矛 爾 
𥎗	矛 與 
𥎘	矛 需 
𥎛	矛 匱 
𥎜	矞 小 天 
𥎟	矛 攵 章 
𥎡	矛 瞿 
𥎢	矛 木 冖 林 灬 
𥎣	矛 竄 
𥎤	矛 爨 
𥏈	⺇ 𢆰 矢 
𥏊	矢 羽 
𥏎	矢 廷 
𥏒	矢 吾 
𥏓	矢 㫒 
𥏕	矢 宏 
𥏖	矢 矣 
𥏘	矢 屈 
𥏙	矢 卷 
𥏜	矢 奇 
𥏝	矢 亞 
𥏠	矢 卑 
𥏤	矢 𡘆 
𥏥	矢 卓 
𥏨	矢 周 
𥏪	矢 皆 
𥏫	矢 昜 
𥏮	矢 音 
𥏯	知 早 
𥏷	土 白 匕 矢 
𥏹	矢 高 
𥐀	矢 斯 
𥐁	矢 菐 
𥐂	上 矢 禺 
𥐊	矢 敫 
𥐑	矢 嬰 
𥐓	矢 雚 
𥐕	石 ⺃ 
𥐘	厂 二 口 
𥑈	石 广 丁 
𥑋	石 圣 
𥑎	石 冋 
𥑏	石 史 
𥑐	石 甲 
𥑑	石 幼 
𥑒	石 尒 
𥑔	石 瓜 
𥑡	石 术 
𥑢	石 布 
𥑣	石 厂 𭅲 
𥑥	石 生 
𥑩	石 𠬦 
𥑫	石 穴 
𥑰	石 左 
𥑱	工 刀 石 
𥑳	石 戎 
𥑴	石 衣 
𥑵	石 𠂤 
𥑶	石 耒 
𥑸	石 舟 
𥑹	石 夸 
𥑺	石 屰 
𥑻	石 先 
𥑼	伐 石 
𥑽	石 𠂆 巴 
𥑾	石 卉 
𥑿	石 有 
𥒀	石 汙 
𥒁	石 州 
𥒓	石 至 
𥒗	石 爫 厶 
𥒘	石 旬 
𥒛	石 𱍸 𠫔 
𥒞	石 羊 
𥒡	石 丞 
𥒢	石 刕 
𥒥	石 多 
𥒧	石 又 龰 
𥒨	石 𠇍 
𥒫	石 孚 
𥒬	石 宋 
𥒭	石 足 
𥒮	石 尾 
𥒰	石 甫 
𥒱	石 形 
𥒲	石 矣 
𥒳	宕 亢 
𥒵	石 邑 
𥒶	石 系 
𥒾	石 吾 
𥓃	石 夂 木 
𥓆	石 又 石 
𥓇	夕 止 石 
𥓈	石 卉 十 
𥓌	石 羌 
𥓍	叔 石 
𥓐	石 疌 
𥓑	石 剎 
𥓒	石 臽 
𥓓	石 𤰞 
𥓖	石 杲 
𥓬	到 石 
𥓭	石 阜 
𥓰	石 穹 
𥓻	石 㚇 
𥓾	石 臿 
𥔀	石 訇 
𥔁	石 畐 
𥔂	石 恆 
𥔇	石 㚚 
𥔊	石 己 至 
𥔑	石 叜 
𥔡	石 香 
𥔢	石 臾 
𥔣	石 姜 
𥔩	砍 石 
𥔪	石 厽 川 
𥔮	石 虔 
𥔯	石 迴 
𥔱	石 扇 
𥔻	神 石 
𥔽	石 荅 
𥕀	石 翁 
𥕁	石 斊 
𥕂	石 脊 
𥕇	石 匚 山 龱 
𥕉	石 厝 
𥕍	石 婁 
𥕎	石 康 
𥕏	石 國 
𥕐	石 啇 
𥕑	石 虘 
𥕓	石 莫 
𥕕	石 虖 
𥕖	石 郭 
𥕘	石 巢 
𥕙	石 丶 生 石 
𥕣	石 得 
𥕦	石 袞 
𥕰	石 虛 
𥕱	石 彭 
𥕲	石 厥 
𥕵	石 敢 
𥕶	石 斯 
𥕸	石 最 
𥕹	石 毳 
𥕻	石 無 
𥕼	石 酓 
𥕽	彭 石 
𥕾	石 艹 一 㡀 
𥕿	番 石 
𥖄	石 羡 
𥖍	溂 石 
𥖗	𰚃 石 
𥖘	石 戡 
𥖙	石 戢 
𥖜	石 禁 
𥖝	石 廉 
𥖞	貇 石 
𥖠	石 蜀 
𥖪	石 蒦 
𥖫	皷 石 
𥖬	石 凴 
𥖵	石 㥯 
𥖶	石 賔 
𥖻	石 數 
𥖼	石 慮 
𥖾	石 適 
𥖿	石 賣 
𥗀	石 蓼 
𥗁	石 箸 
𥗊	石 齒 
𥗒	石 親 
𥗓	石 賴 
𥗙	石 學 
𥗚	殸 必 石 
𥗝	石 襄 
𥗟	石 謈 
𥗦	石 鍾 
𥗫	石 瞿 
𥗬	石 壘 
𥗭	石 雜 
𥗮	石 闕 
𥗵	石 礜 
𥗶	香 鬼 石 
𥗺	石 蘭 
𥗽	石 覽 
𥗿	石 𡿏 
𥘁	石 蘿 
𥘄	石 鬱 
𥘊	示 丩 
𥘋	示 力 
𥘌	示 几 
𥘏	示 干 
𥘑	示 寸 
𥘒	示 弋 
𥘠	示 卄 一 
𥘡	示 互 
𥘤	示 少 
𥘥	示 升 
𥘦	示 攵 
𥘫	示 可 
𥘬	示 弗 
𥘮	示 句 
𥙀	示 左 
𥙁	示 㐌 
𥙆	示 玄 
𥙇	示 它 
𥙉	示 台 
𥙋	示 出 
𥙎	示 𠂢 
𥙡	示 𠂉 丹 
𥙣	示 旬 
𥙦	如 示 
𥙨	示 朵 
𥙫	示 酉 
𥙬	示 肖 
𥙰	示 气 土 
𥙾	示 秀 
𥙿	示 谷 
𥚂	示 夋 
𥚉	示 甾 
𥚊	示 坴 
𥚚	示 虎 
𥚛	示 昆 
𥚟	示 𰃦 古 
𥚠	示 享 
𥚦	示 矦 
𥚩	示 胥 
𥚾	示 㚇 
𥚿	示 龹 女 
𥛂	示 右 月 
𥛅	示 留 
𥛑	示 辱 
𥛘	示 畢 
𥛚	示 啇 
𥛜	示 虘 
𥛝	示 逢 
𥛞	示 鹿 
𥛟	示 覓 
𥛥	示 專 
𥛧	示 累 
𥛨	示 徙 
𥛩	示 庾 
𥛪	示 𢉖 
𥛫	示 梁 
𥛯	示 矞 
𥛰	示 尞 
𥛱	彭 示 
𥛽	示 畱 
𥜃	示 睪 
𥜄	糸 弓 攵 示 
𥜌	示 奧 
𥜏	示 日 冖 夕 灬 
𥜐	示 黽 
𥜒	示 厭 
𥜓	示 監 
𥜖	束 矣 示 
𥜙	漸 示 
𥜚	示 憂 
𥜥	示 冀 
𥜦	示 壐 
𥜬	示 爾 王 
𥜭	示 亯 凵 口 口 丨 
𥜮	示 麏 
𥜰	示 麗 
𥜲	示 繭 
𥜴	示 騫 
𥜵	示 矍 
𥜶	示 夔 
𥝀	禹 也 
𥝂	禺 厄 
𥝄	丱 龱 禸 
𥝊	𦥯 禹 
𥝋	𦥑 𦥑 囟 禸 
𥝍	禾 一 
𥝑	禾 丂 
𥝒	禾 卜 
𥝔	禾 孑 
𥝕	禾 亡 
𥝖	禾 乞 
𥝘	禾 夕 
𥝟	禾 土 
𥝠	禾 么 
𥝢	禾 𠚣 
𥝥	禾 及 
𥝦	禾 丑 
𥝧	禾 巴 
𥝨	禾 仒 
𥝩	爫 禾 
𥝮	禾 𢆰 
𥝸	禾 水 
𥝹	禾 斤 
𥝾	禾 厂 乇 
𥝿	禾 加 
𥞁	禾 申 
𥞃	禾 出 
𥞄	禾 片 
𥞅	禾 此 
𥞊	禾 未 
𥞍	禾 可 
𥞎	禾 布 
𥞏	禾 兄 
𥞑	禾 市 
𥞒	禾 它 
𥞘	禾 存 
𥞚	禾 如 
𥞛	禾 朵 
𥞜	禾 夅 
𥞥	列 禾 
𥞧	禾 行 
𥞩	禾 并 
𥞪	禾 米 
𥞯	禾 丶 平 
𥞲	禾 別 
𥞴	禾 告 
𥞵	禾 夾 
𥞺	禾 足 
𥞼	禾 夂 月 
𥟍	禾 非 
𥟎	禾 劵 
𥟒	禾 叕 
𥟓	禾 官 
𥟔	禾 𣅳 
𥟕	禾 芡 
𥟗	禾 畁 
𥟘	禾 易 
𥟚	禾 必 土 
𥟪	禾 芼 
𥟶	禾 宛 
𥟽	禾 屋 
𥟾	禾 苦 
𥟿	多 委 
𥠀	禾 星 
𥠁	禾 咼 
𥠃	禾 幽 
𥠄	禾 耑 
𥠅	禾 奐 
𥠈	禾 即 
𥠉	禾 則 
𥠊	禾 柔 
𥠋	禾 咠 
𥠍	禾 不 生 
𥠛	禾 丙 攵 
𥠜	禾 昜 
𥠡	禾 怱 
𥠩	禾 𠫵 
𥠲	禾 栗 
𥠳	禾 骨 
𥠴	禾 鬯 
𥠶	禾 匪 
𥠷	禾 留 
𥠹	禾 桀 
𥠺	禾 𥁕 
𥠽	禾 致 
𥡀	弗 秝 
𥡁	秘 尒 
𥡃	禾 荒 
𥡅	禾 皋 
𥡒	禾 斊 
𥡜	禾 累 
𥡟	禾 舂 
𥡠	禾 爽 
𥡢	禾 率 
𥡣	禾 堇 
𥡤	禾 酉 灬 
𥡦	禾 啇 
𥡧	禾 虘 
𥡪	禾 翌 
𥡬	禾 從 
𥡭	垂 委 
𥡮	𥞤 加 
𥡴	禾 尤 上 日 
𥡽	禾 ⺈ 𠃊 目 夂 
𥢇	禾 艹 束 
𥢊	禾 賁 
𥢌	禾 番 
𥢍	禾 辜 
𥢎	禾 尊 
𥢏	禾 覃 
𥢐	禾 臯 
𥢑	𮂱 咎 
𥢒	禾 勞 
𥢔	禾 尤 卓 
𥢟	禾 古 芊 
𥢢	禾 貴 
𥢦	禾 夂 田 灬 
𥢧	禾 戠 
𥢮	士 双 秝 
𥢲	秝 成 
𥢶	禾 會 
𥢷	禾 當 
𥢸	禾 葛 
𥢹	禾 敫 
𥢻	禾 禁 
𥢽	禾 粲 
𥣆	禾 㚘 禾 
𥣈	禾 業 
𥣋	禾 蜀 
𥣌	禾 山 用 用 
𥣗	禾 寧 
𥣘	禾 厭 
𥣙	禾 聚 
𥣛	禾 蒙 
𥣝	禾 扁 禾 
𥣤	秝 泉 
𥣥	𥝢 桼 
𥣩	禾 𢧵 
𥣫	禾 蔑 
𥣬	禾 畾 
𥣮	禾 節 
𥣯	禾 憂 
𥣰	禾 臱 
𥣱	禾 來 一 回 
𥣸	秝 大 豆 
𥣹	禾 𤎉 
𥣺	禾 𠔥 土 
𥤂	禾 褭 
𥤊	禾 雚 
𥤋	聶 禾 
𥤐	禾 壘 
𥤗	禾 黨 
𥤘	禾 矍 
𥤜	禾 蘦 
𥤞	禾 靈 
𥤟	禾 鹽 
𥤡	驫 禾 
𥤣	穴 了 
𥤤	穴 几 
𥤥	穴 七 
𥤦	穴 又 
𥤨	穴 女 
𥤩	穴 亡 
𥤱	穴 干 
𥤳	穴 乆 
𥤴	穴 开 
𥤵	穴 丏 
𥤷	穴 冘 
𥤸	穴 元 
𥤹	穴 爻 
𥤺	穴 手 
𥤻	穴 比 
𥤼	穴 水 
𥥅	穴 孔 
𥥈	穴 弘 
𥥊	穴 皿 
𥥋	穴 令 
𥥌	穴 失 
𥥍	穴 𡗜 
𥥛	穴 犮 
𥥝	穴 用 
𥥟	穴 瓦 
𥥠	穴 危 
𥥡	穴 共 
𥥥	穴 吏 
𥥧	穴 老 
𥥩	穴 向 
𥥱	穴 死 
𥥳	穴 舟 
𥥴	穴 衣 
𥥵	穴 羊 
𥥶	穴 廷 
𥥷	穴 豆 
𥥸	穴 余 
𥥹	穴 丣 
𥥻	穴 巠 
𥥽	穴 求 
𥥾	穴 肙 
𥥿	穴 夕 火 
𥦀	穴 見 
𥦁	穴 甬 
𥦃	穴 杘 
𥦅	穴 𨙺 
𥦊	穴 坐 
𥦌	穴 弄 
𥦍	穴 㫒 
𥦔	穴 坎 
𥦖	穴 呌 
𥦗	穴 𢗀 
𥦘	穴 孚 
𥦜	穴 朋 
𥦝	穴 林 
𥦞	穴 臤 
𥦟	穴 典 
𥦢	穴 邪 
𥦥	穴 𠈣 
𥦨	穴 金 
𥦶	臽 穴 
𥦷	穴 泓 
𥦿	穴 恄 
𥧂	穴 贡 刂 
𥧆	穴 禺 
𥧇	穴 科 
𥧋	穴 屏 
𥧑	穴 眞 
𥧒	穴 冓 
𥧓	穴 馬 
𥧔	穴 氣 
𥧕	穴 流 
𥧙	穴 𬂧 
𥧚	穴 女 坐 
𥧡	穴 貢 
𥧣	穴 茶 
𥧤	穴 日 尖 
𥧦	穴 悎 
𥧧	穴 𥁑 
𥧫	穴 郎 
𥧬	穴 堅 
𥧭	穴 曼 
𥧮	穴 啇 
𥧰	穴 瓠 
𥧱	穴 庸 
𥧲	穴 㴆 
𥧴	穴 𱞩 
𥧷	穴 牜 呆 
𥧻	穴 𠁅 
𥨉	穴 爿 言 
𥨌	穴 畱 
𥨍	穴 復 
𥨎	穴 覃 
𥨐	穴 𠞖 
𥨒	穴 𠭥 
𥨕	穴 惺 
𥨜	弆 突 
𥨝	穴 彳 叜 
𥨪	䆤 邑 
𥨳	穴 耳 革 
𥨻	穴 歷 
𥨿	穴 激 
𥩀	穴 橐 
𥩓	穴 龷 米 ⺊ 𠔿 冋 
𥩔	穴 靈 
𥩖	立 卜 
𥩗	立 兀 
𥩙	立 巴 
𥩝	立 手 
𥩡	立 戉 
𥩢	立 且 
𥩣	立 主 
𥩤	立 可 
𥩮	立 句 
𥩱	立 伐 
𥩲	立 亥 
𥪀	立 甫 
𥪁	立 甹 
𥪂	立 夾 
𥪊	立 屈 
𥪋	立 彔 
𥪌	立 忝 
𥪍	立 委 
𥪏	立 取 
𥪘	立 甚 
𥪚	立 复 
𥪢	童 八 
𥪦	立 奚 
𥪧	立 眞 
𥪫	立 茤 
𥪯	立 堯 
𥪱	旋 立 
𥪴	章 夅 
𥪵	臿 妾 
𥪻	耳 尢 彡 立 
𥪼	竒 竒 
𥫀	立 𬴳 
𥫂	旬 童 
𥫃	立 義 
𥫅	糹 昌 立 
𥫋	𰄔 竝 
𥫎	童 貟 
𥫔	𥪴 貝 
𥫖	章 吅 㸚 
𥫙	竹 丁 
𥫛	竹 厶 
𥫜	竹 乂 
𥫝	竹 弋 
𥫞	竹 子 
𥫟	竹 己 
𥫢	竹 叉 
𥫯	竹 中 
𥫰	竹 六 
𥫱	竹 屯 
𥫳	竹 方 
𥫴	竹 巿 
𥫵	竹 太 
𥫶	竹 亓 
𥫷	竹 勼 
𥫸	竹 水 
𥫹	竹 冘 
𥫼	竹 丹 
𥫽	竹 氏 
𥬀	竹 云 
𥬆	竹 井 
𥬈	竹 从 
𥬉	竹 勾 
𥬍	竹 仙 
𥬎	竹 末 
𥬐	竹 申 
𥬒	竹 犮 
𥬓	竹 幼 
𥬔	竹 去 
𥬕	竹 冉 
𥬙	竹 巨 
𥬜	竹 勹 匕 
𥬝	竹 白 
𥬞	竹 尔 
𥬠	竹 刍 
𥬪	竹 戎 
𥬫	竹 舛 
𥬬	竹 帇 
𥬭	竹 列 
𥬮	竹 江 
𥬯	竹 考 
𥬰	竹 𠕋 
𥬱	竹 充 
𥬲	竹 朵 
𥬳	竹 此 
𥬴	竹 羊 
𥬼	竹 刎 
𥭋	竹 多 
𥭌	竹 宅 
𥭐	竹 寽 
𥭑	竹 求 
𥭒	竹 囤 
𥭓	竹 灼 
𥭔	竹 占 刂 
𥭖	竹 ⺼ 勺 
𥭘	竹 希 
𥭙	竹 耳 乚 
𥭚	竹 吂 
𥭜	竹 忌 
𥭝	竹 妙 
𥭞	竹 肙 
𥭟	竹 夋 
𥭠	竹 吾 
𥭡	竹 志 
𥭢	竹 甹 
𥭥	竹 䖝 
𥭫	竹 卩 尔 
𥭬	竹 𦘴 
𥭭	竹 坐 
𥭮	竹 囧 
𥮍	竹 㸒 
𥮎	𥫠 犬 
𥮏	竹 典 
𥮐	竹 周 
𥮒	竹 沾 
𥮕	竹 杭 
𥮖	竹 直 
𥮗	竹 匊 
𥮘	竹 念 
𥮚	竹 𠛹 
𥮜	竹 弥 
𥮝	竹 屈 
𥮣	竹 𦊋 
𥮤	竹 隶 
𥮥	竹 析 
𥮧	竹 𣏋 
𥮨	竹 忩 
𥮪	竹 𦙃 
𥮬	竹 易 
𥮯	符 大 
𥮾	竹 参 
𥯃	竹 奄 
𥯑	竹 垔 
𥯔	竹 禹 
𥯕	竹 昜 
𥯖	竹 度 
𥯘	竹 耶 
𥯙	竹 勁 
𥯚	竹 恪 
𥯛	竹 洛 
𥯜	竹 畏 
𥯝	竹 突 
𥯞	竹 斿 
𥯟	竹 拜 
𥯡	竹 毗 
𥯢	竹 亭 
𥯣	竹 𠔿 戍 
𥯤	竹 韋 
𥯥	竹 臿 
𥯦	竹 建 
𥯨	竹 思 
𥯩	竹 斫 
𥯪	竹 奏 
𥯬	竹 耎 
𥯮	竹 臾 
𥯳	竹 咢 
𥯶	竹 苦 
𥯸	竹 柱 
𥯾	竹 宀 ⾆ 
𥰛	竹 浮 
𥰜	竹 桃 
𥰝	竹 息 
𥰞	竹 叟 
𥰟	竹 袁 
𥰠	竹 旅 
𥰡	竹 敇 
𥰢	竹 扇 
𥰣	竹 留 
𥰥	竹 奚 
𥰦	竹 屐 
𥰧	竹 倚 
𥰨	竹 剡 
𥰪	竹 挐 
𥰫	筴 口 
𥰭	竹 差 
𥰮	竹 哿 
𥰰	筮 廾 
𥰱	竹 蚤 
𥰲	竹 烘 
𥰳	竹 𮜿 
𥰶	竹 害 
𥰻	竹 旲 口 
𥰼	竹 索 
𥰾	竹 窄 
𥱀	竹 洿 
𥱁	竹 冏 大 
𥱃	竹 𨓜 
𥱒	竹 氵 巫 
𥱧	竹 秦 
𥱨	竹 素 
𥱵	竹 習 
𥱶	竹 爽 
𥱷	竹 貪 
𥱹	竹 莫 
𥱻	竹 途 
𥱼	竹 氵 卑 
𥱽	竹 圈 
𥲀	竹 巢 
𥲁	竹 而 瓦 
𥲂	竹 氵 幷 
𥲃	竹 寇 
𥲄	竹 淡 
𥲅	竹 𠃬 心 
𥲆	竹 通 
𥲇	竹 身 冘 
𥲈	竹 㒼 
𥲉	竹 虖 
𥲊	竹 聊 
𥲋	竹 衒 
𥲍	竹 曹 
𥲎	竹 陸 
𥲏	竹 㫒 殳 
𥲐	竹 梧 
𥲑	竹 曼 
𥲕	竹 紫 
𥲗	竹 䧑 
𥲚	竹 淙 
𥲛	竹 紨 
𥲜	竹 虍 皿 
𥲝	竹 ⺕ ⺕ 皮 
𥲟	竹 釣 
𥲠	竹 望 
𥲡	竹 穴 厶 心 
𥲢	竹 囗 林 
𥲣	竹 貝 斤 
𥲥	竹 盒 
𥲦	竹 覀 𡗜 
𥲧	竹 梨 
𥲪	竹 𠩺 
𥲽	辶 𥭭 
𥳆	竹 敝 
𥳇	竹 復 
𥳈	竹 毳 
𥳉	竹 都 
𥳋	竹 叅 
𥳌	竹 隆 
𥳍	竹 尋 
𥳎	筑 虫 
𥳏	竹 幾 
𥳐	竹 開 
𥳒	竹 減 
𥳓	竹 稍 
𥳔	竹 隋 
𥳕	竹 舒 
𥳖	竹 棓 
𥳗	竹 須 
𥳘	竹 童 
𥳚	竹 然 
𥳜	竹 陽 
𥳝	竹 惢 
𥳞	竹 粦 
𥳟	竹 進 
𥳠	竹 𨔛 
𥳡	竹 賁 
𥳢	竹 奠 
𥳣	竹 最 
𥳥	竹 甯 
𥳪	辶 算 
𥳫	竹 典 月 
𥳬	竹 黑 
𥳯	竹 棤 
𥳰	竹 尊 
𥳱	竹 兟 
𥳲	竹 ⻖ 昱 
𥳳	竹 提 
𥳴	竹 殽 
𥳵	竹 絕 
𥳶	竹 掌 
𥳷	竹 湔 
𥳸	竹 仝 見 
𥳹	竹 仝 貝 
𥳺	竹 揔 
𥳽	竹 欺 
𥴐	竹 㠭 
𥴑	竹 酉 生 
𥴕	竹 猶 
𥴖	竹 椑 
𥴡	竹 豊 
𥴤	竹 腱 
𥴦	竹 遂 
𥴧	竹 豦 
𥴨	竹 愛 
𥴩	竹 隔 
𥴪	竹 遇 
𥴫	竹 殿 
𥴬	竹 辟 
𥴭	竹 楬 
𥴮	竹 搏 
𥴯	竹 廆 
𥴱	竹 廌 
𥴴	竹 鉤 
𥴵	竹 旲 虫 
𥴺	竹 慈 
𥴻	竹 搶 
𥵒	竹 日 冖 見 
𥵜	竹 僕 
𥵝	竹 領 
𥵞	竹 截 
𥵟	竹 署 
𥵠	竹 穀 
𥵣	竹 端 
𥵤	竹 綽 
𥵦	竹 𨲆 
𥵧	竹 盡 
𥵨	竹 臱 
𥵪	竹 竮 
𥵫	竹 聚 
𥵬	竹 廖 
𥵯	竹 𬺻 疌 
𥵶	竹 典 ⾆ 
𥶅	竹 氵 畱 
𥶆	竹 閭 
𥶇	竹 魯 
𥶈	竹 皺 
𥶌	竹 慮 
𥶍	竹 緩 
𥶏	竹 調 
𥶐	竹 隤 
𥶑	竹 養 
𥶒	竹 炎 舛 
𥶓	竹 罷 
𥶔	竹 麃 
𥶕	竹 戶 比 舌 
𥶗	竹 𠤕 籴 
𥶛	竹 踶 
𥶜	竹 嫴 
𥶢	竹 巛 龱 ⺇ 氺 
𥶵	竹 毇 
𥶶	竹 幸 匊 
𥶷	竹 選 
𥶹	竹 靜 
𥶺	箕 𣏋 
𥶻	竹 隨 
𥶽	竹 衞 
𥶿	竹 閻 
𥷀	竹 燕 
𥷁	竹 辦 
𥷃	竹 槳 
𥷄	竹 𠆢 爾 
𥷅	竹 㷴 
𥷆	竹 縠 
𥷇	竹 器 
𥷈	竹 橦 
𥷑	箴 角 
𥷔	竹 輿 
𥷕	竹 其 枼 
𥷖	竹 甐 
𥷗	竹 隸 
𥷘	竹 擢 
𥷙	竹 罽 
𥷚	竹 幸 訇 
𥷜	竹 隹 風 
𥷨	竹 聶 
𥷩	竹 雜 
𥷪	竹 扌 𢦏 韭 
𥷫	竹 黠 
𥷬	竹 雚 
𥷮	竹 爵 
𥷱	竹 覆 
𥷼	竹 就 足 
𥸅	竹 𨘢 
𥸈	竹 黨 
𥸉	籠 木 
𥸊	竹 豙 頁 
𥸗	竹 灑 
𥸘	竹 氵 矍 
𥸚	竹 覿 
𥸡	竹 贛 
𥸢	竹 蠶 
𥸣	竹 黵 
𥸤	籥 頁 
𥸥	𠃌 米 
𥸧	米 丁 
𥸪	米 人 
𥸬	米 ⻏ 
𥸲	米 弓 
𥸴	米 丏 
𥸵	米 屯 
𥹁	米 乍 
𥹂	米 丕 
𥹄	⺊ 冖 釆 
𥹆	米 尼 
𥹇	米 弁 
𥹈	米 它 
𥹊	米 四 
𥹋	米 台 
𥹌	加 米 
𥹍	米 宁 
𥹓	米 去 
𥹔	米 犮 
𥹖	米 皮 
𥹚	米 亘 
𥹛	九 攵 米 
𥹜	米 交 
𥹠	米 多 
𥹩	米 寺 
𥹬	米 考 
𥹱	米 幼 
𥹲	米 兌 
𥹳	米 完 
𥹴	米 步 
𥹵	米 束 
𥹶	米 肖 
𥹷	米 㐬 
𥹸	米 孛 
𥹻	米 弃 
𥺅	米 寿 
𥺉	米 豆 
𥺊	米 告 
𥺙	米 夌 
𥺚	米 析 
𥺜	泥 米 
𥺝	米 周 
𥺞	米 育 
𥺡	米 陁 
𥺣	米 丑 丑 
𥺴	米 念 
𥺵	米 殳 月 
𥺷	米 屈 
𥻄	米 皆 
𥻆	𠧪 米 
𥻇	米 咸 
𥻉	米 曷 
𥻋	粦 八 
𥻍	米 𣆊 
𥻑	米 禺 
𥻒	𥹫 夕 
𥻝	米 重 
𥻞	米 客 
𥻤	米 芻 
𥻥	米 鬲 
𥻦	殺 米 
𥻧	米 兼 
𥻨	米 索 
𥻩	米 冥 
𥻫	𥸨 𥸨 
𥻬	米 隻 
𥻮	米 宰 
𥻴	夏 米 
𥻵	米 時 
𥻾	𥹫 及 
𥻿	米 离 
𥼀	米 戚 
𥼂	米 崔 
𥼃	米 責 
𥼅	𭆆 米 
𥼋	𠩺 米 
𥼓	米 𤰈 
𥼘	米 幾 
𥼚	米 焦 
𥼛	毳 米 
𥼜	米 菐 
𥼝	米 禽 
𥼞	米 非 灬 
𥼟	米 丿 ⺫ 乑 
𥼩	米 貴 
𥼪	米 㫺 
𥼫	𥹫 多 
𥼬	𥹫 米 
𥼭	米 粦 
𥼮	米 糸 米 
𥼶	米 睪 
𥼸	米 零 
𥼺	米 辠 
𥼻	米 資 
𥼼	米 敷 
𥽁	米 飲 
𥽈	米 豊 
𥽐	臣 侖 米 
𥽒	米 丗 丗 木 
𥽗	米 樂 
𥽟	米 憂 
𥽥	米 霍 
𥽧	竹 㚔 籴 
𥽬	米 襄 
𥽰	米 糜 
𥽳	𦥯 咠 
𥽶	米 覈 
𥽸	米 䜌 
𥽹	粟 喿 
𥾂	米 靈 
𥾅	糹 十 
𥾇	糹 了 
𥾊	糹 几 
𥾋	糹 乃 
𥾌	糹 孑 
𥾍	糹 干 
𥾐	糹 弋 
𥾓	糹 个 
𥾕	糹 兀 
𥾚	糹 冗 
𥾛	糹 切 
𥾝	糹 丏 
𥾡	糹 勻 
𥾣	糹 支 
𥾤	糹 又 又 
𥾧	糹 巿 
𥾨	糹 气 
𥾮	糹 戈 
𥾯	糹 弔 
𥾹	糹 手 
𥾼	糹 亠 了 
𥿃	加 糸 
𥿄	糹 氐 
𥿅	矢 糸 
𥿆	糹 司 
𥿇	糹 疋 
𥿉	糹 末 
𥿊	糹 斥 
𥿋	糹 弁 
𥿍	糹 古 
𥿎	糹 夗 
𥿑	糹 𠕁 
𥿚	土 刀 糸 
𥿜	糹 𠂉 小 
𥿝	代 糸 
𥿞	糹 他 
𥿦	糹 舟 
𥿧	糹 向 
𥿨	糹 名 
𥿩	次 糸 
𥿪	糹 㠩 
𥿫	糹 多 
𥿭	糹 𠫤 
𥿮	糹 式 
𥿯	糹 𠂢 
𥿰	糹 朶 
𥿴	糹 𣎽 
𥿵	糹 厶 午 
𥿷	糹 刃 刃 
𥿹	糹 亦 
𥿺	糸 妄 
𦀇	糹 𡉊 
𦀓	糹 辛 
𦀔	糹 甹 
𦀕	糹 邑 
𦀖	糹 劫 
𦀘	糹 坒 
𦀛	糹 沙 
𦀜	糹 壯 
𦀝	糹 囧 
𦀠	糹 㐬 
𦀡	糹 吾 
𦀣	丿 幺 幺 糸 
𦀨	糹 那 
𦀸	糹 皃 
𦁄	糹 辰 
𦁆	糹 叀 
𦁇	糹 𫝹 
𦁈	糹 空 
𦁉	糹 妾 
𦁊	糹 卦 
𦁍	糹 㸒 
𦁎	糹 昔 
𦁏	糹 奄 
𦁐	糹 屈 
𦁕	糹 忽 
𦁖	糹 宙 
𦁗	糹 歩 
𦁙	糹 兖 
𦁛	糹 𣏋 
𦁜	糹 𣏼 
𦁟	糹 𮝾 
𦁲	糹 虎 
𦁳	糹 季 
𦁶	糹 庚 
𦁷	紡 厷 
𦂀	糸 度 
𦂄	糸 皆 
𦂅	糸 枲 
𦂆	糸 廻 
𦂇	糸 䖍 
𦂈	糸 胄 
𦂉	糸 臿 
𦂊	糸 㚆 
𦂋	糸 尼 木 
𦂌	封 糸 
𦂍	糸 若 
𦂐	糸 矦 
𦂑	糸 夕 吉 
𦂒	糸 前 
𦂔	糸 勉 
𦂕	糸 禺 
𦂖	糸 𢍉 
𦂗	削 糸 
𦂠	糸 亰 
𦂡	糸 羍 
𦂶	糸 竒 
𦃄	糸 匪 
𦃊	糸 栗 
𦃋	糸 𣬉 
𦃒	糸 祟 
𦃓	糸 留 
𦃔	糸 鬲 
𦃕	糸 㤻 
𦃖	糸 剡 
𦃗	朔 糸 
𦃘	糸 屖 
𦃙	日 共 糸 
𦃝	糸 䒺 
𦃡	糸 夂 糸 
𦃢	厂 緊 
𦃤	務 糸 
𦃽	糸 邕 
𦄂	糸 帶 
𦄋	糸 鳥 
𦄌	糸 埶 
𦄍	糸 爽 
𦄏	糸 梢 
𦄐	鹿 糸 
𦄑	糸 彗 
𦄔	糸 窒 
𦄜	糸 㓞 示 
𦄧	糸 曹 
𦄯	專 糸 
𦄰	糸 國 
𦄼	糸 須 
𦄽	糸 渠 
𦄿	糸 黑 
𦅀	糸 尋 
𦅃	糸 焦 
𦅄	糸 𰕎 
𦅆	糸 奠 
𦅇	糸 喪 
𦅈	糸 彭 
𦅊	糸 㫺 
𦅋	糸 㚘 心 
𦅏	糸 𦓔 
𦅑	糸 循 
𦅔	黑 糸 
𦅗	糸 羡 
𦅨	須 糸 
𦅵	糸 歲 
𦅶	糸 葛 
𦅷	糸 著 
𦅸	䍃 ⺊ 系 
𦅺	糸 戾 皿 
𦅻	素 爰 
𦅼	糸 詹 
𦅽	𠂹 一 八 糸 
𦅾	敫 糸 
𦅿	糸 暈 
𦆀	糸 羨 
𦆁	𣎆 糸 
𦆄	糸 瑟 
𦆆	糸 廉 
𦆈	糸 雋 
𦆌	糸 亠 叕 大 
𦆘	糸 𤾇 
𦆞	糸 舞 
𦆟	糸 蒙 
𦆡	糸 厂 㲜 
𦆤	糸 𤕨 
𦆦	糸 疑 
𦆲	糸 廖 
𦆸	糸 遙 
𦆻	糸 巤 
𦆾	素 率 
𦇀	糸 慧 
𦇁	糸 敷 
𦇄	糸 畾 
𦇎	糸 蔥 
𦇔	糸 歷 
𦇖	糸 頻 
𦇘	糸 麇 
𦇙	糸 舉 
𦇛	糸 賴 
𦇧	糸 罽 
𦇬	糸 龠 
𦇭	糸 辶 白 穴 口 
𦇱	糸 叢 
𦇲	糸 𤕨 土 
𦇸	糸 覈 
𦈃	糸 囊 
𦈅	糸 畾 宜 
𦈈	纟 斥 
𦈉	纟 军 
𦈋	纟 酉 
𦈌	纟 束 
𦈎	纟 单 
𦈏	纟 氏 日 
𦈐	纟 连 
𦈑	纟 垔 
𦈒	纟 枲 
𦈓	纟 畏 
𦈔	纟 骨 
𦈕	纟 俞 
𦈖	纟 𦐇 
𦈗	纟 匪 
𦈘	纟 荅 
𦈙	纟 聂 
𦈚	纟 戚 
𦈛	纟 最 
𦈜	纟 集 
𦈝	纟 巽 
𦈞	纟 辟 
𦈟	纟 禁 
𦈠	纟 㥯 
𦈣	缶 亏 
𦈤	缶 丿 𠀁 
𦈦	缶 火 
𦈧	缶 不 
𦈨	缶 开 
𦈩	工 几 缶 
𦈬	此 缶 
𦈰	缶 圭 
𦈲	缶 亥 
𦈵	缶 巠 
𦈶	缶 否 
𦈷	缶 㐬 
𦈸	缶 或 
𦈺	缶 周 
𦈻	缶 戔 
𦉂	缶 重 
𦉆	缶 查 
𦉈	𠂹 缶 
𦉉	缶 留 
𦉎	缶 崔 
𦉐	缶 瓶 
𦉙	缶 廌 
𦉝	𦥑 同 缶 
𦉟	缶 齒 
𦉢	缶 霝 
𦉥	雝 缶 
𦉧	獻 缶 
𦉪	冂 儿 
𦉬	罒 丁 
𦉹	罒 勺 
𦊁	罒 比 
𦊂	罒 互 
𦊃	罒 今 
𦊊	罒 天 
𦊋	⺱ 木 
𦊌	𠕀 月 
𦊍	网 互 
𦊎	罒 示 
𦊐	罒 巨 
𦊑	罒 卯 
𦊓	罒 令 
𦊗	𠕀 夗 
𦊘	网 禾 
𦊦	𠔿 冖 巳 
𦊧	㘝 木 
𦊪	网 合 
𦊫	罒 光 
𦊬	⺱ 衣 
𦊱	𠔿 圭 
𦊹	𠔿 各 
𦊻	㘝 ⺄ 木 
𦊼	罒 呂 
𦊽	罒 豕 
𦊾	罒 否 
𦊿	罒 丣 
𦋅	罒 勹 圭 
𦋆	罒 孤 
𦋈	罒 戔 
𦋉	罒 服 
𦋋	罒 㲎 
𦋓	罒 卷 
𦋔	𠔿 录 
𦋞	罒 削 
𦋡	罒 某 
𦋢	𠕀 俞 
𦋣	罒 凾 
𦋩	𠔿 約 
𦋪	𦉴 延 
𦋯	罒 㼌 
𦋰	罒 兼 
𦋳	罒 罡 
𦋿	罒 曹 
𦌀	罒 參 
𦌁	罒 婁 
𦌉	罒 敕 
𦌊	罒 欶 
𦌋	罒 𫝀 𫝀 八 土 
𦌒	罒 尞 
𦌔	罒 巽 
𦌕	罒 路 
𦌗	罒 欻 
𦌚	罒 奠 
𦌟	罒 祿 
𦌡	罒 黽 
𦌢	罒 綈 
𦌦	罒 京 瓜 
𦌪	罒 緂 
𦌬	罒 舞 
𦌭	罒 馽 
𦌰	罒 綺 
𦌷	罒 賣 
𦌸	罒 𩵢 
𦌺	君 睘 
𦌾	罒 繯 
𦌿	罒 麗 
𦍀	罒 難 
𦍁	罒 繴 
𦍄	罒 昍 𢉖 
𦍅	⺱ 䠣 
𦍌	䒑 土 
𦍏	羊 人 
𦍒	土 羊 
𦍕	犭 羊 
𦍚	卝 土 火 
𦍦	羊 出 
𦍧	此 羊 
𦍩	羊 古 
𦍪	羊 㐱 
𦍭	羊 瓦 
𦍱	羊 犮 
𦍲	歺 羊 
𦍴	羊 尔 
𦍵	羊 句 
𦍷	羊 皮 
𦍸	𦍌 𠂇 寸 
𦍹	多 羊 
𦍺	羊 字 
𦍼	羊 亘 
𦎄	羊 死 
𦎇	羊 豕 
𦎈	羊 角 
𦎊	羊 㒵 
𦎌	羊 含 
𦎎	羊 甫 
𦎏	羊 束 
𦎐	羊 里 
𦎒	身 羊 
𦎓	羊 㐬 
𦎘	羊 或 
𦎚	入 羊 九 手 
𦎜	羊 豖 
𦎝	目 羍 
𦎞	羊 乳 
𦎢	羊 亟 
𦎣	羊 垔 
𦎦	敄 羊 
𦎧	亯 ⺸ 
𦎨	眉 羊 
𦎫	亯 羊 
𦎭	羊 复 
𦎮	羊 𫨻 
𦎯	𣪊 羊 
𦎰	羊 骨 
𦎱	羊 害 
𦎵	羊 能 
𦎷	執 羊 
𦎸	羊 責 
𦎹	羊 婁 
𦎼	殻 羊 
𦏀	羊 覔 
𦏁	𦍌 禾 戈 乃 
𦏂	羊 ⺈ ⺼ 几 口 
𦏅	羊 厥 
𦏆	羊 童 
𦏇	羑 羑 
𦏔	羊 喜 
𦏕	羊 蜀 
𦏗	𦥯 羔 
𦏛	羊 喿 
𦏜	與 羊 
𦏢	羊 賣 
𦏤	羊 𠾳 
𦏥	羊 而 口 口 大 
𦏦	羊 𭗐 
𦏧	𦎫 𠃨 
𦏨	羊 褱 
𦏳	羽 ⺃ 
𦏷	大 羽 
𦏸	羽 也 
𦏹	羽 干 
𦏺	工 羽 
𦏻	羽 亏 
𦏿	山 羽 
𦐁	也 羽 
𦐄	亢 羽 
𦐅	羽 及 
𦐆	羽 巴 
𦐇	日 羽 
𦐈	分 羽 
𦐉	㞢 羽 
𦐌	羽 厷 
𦐍	羽 夬 
𦐖	羽 只 
𦐛	句 羽 
𦐠	羽 氐 
𦐡	弗 羽 
𦐣	羽 朱 
𦐤	亥 羽 
𦐦	羽 各 
𦐧	羽 幵 
𦐨	朱 羽 
𦐰	圭 羽 
𦐳	比 冖 羽 
𦐸	否 羽 
𦐹	羽 辛 
𦐺	肖 羽 
𦐽	肙 羽 
𦐾	束 羽 
𦐿	羽 廷 
𦑀	羽 皃 
𦑇	沓 羽 
𦑈	羽 疌 
𦑋	卒 羽 
𦑌	羽 或 
𦑍	或 羽 
𦑎	羽 奄 
𦑏	羽 隹 
𦑑	忄 左 羽 
𦑘	咸 羽 
𦑙	彖 羽 
𦑚	羽 矦 
𦑛	羽 爰 
𦑜	革 羽 
𦑝	重 羽 
𦑞	羽 畐 
𦑟	羽 訇 
𦑠	羽 皇 
𦑡	是 羽 
𦑣	羽 臿 
𦑭	畐 羽 
𦑯	羽 疌 
𦑱	隺 羽 
𦑲	𥄳 羽 
𦑵	尃 羽 
𦑶	羽 𥄳 
𦑸	彳 氵 攵 羽 
𦑹	臼 日 羽 
𦑺	差 羽 
𦑻	韋 羽 
𦑼	羽 𦐇 
𦑾	羽 一 一 昍 
𦒁	羽 差 
𦒆	習 羽 
𦒈	合 𠕁 羽 
𦒋	倝 一 羽 
𦒎	羽 惠 
𦒏	羽 堯 
𦒐	羽 敝 
𦒑	矞 羽 
𦒜	亶 羽 
𦒝	感 羽 
𦒟	𦥭 羽 
𦒢	丿 睪 羽 
𦒦	羽 巤 
𦒧	霍 羽 
𦒰	泰 翟 
𦒴	老 山 
𦒶	耂 勿 
𦒺	老 口 又 
𦒻	耂 占 
𦓍	者 單 仁 
𦓎	而 刂 
𦓐	丿 𦉫 
𦓓	瓦 而 
𦓕	而 曳 
𦓖	而 忍 
𦓚	𠂋 巳 耑 
𦓝	巵 耑 
𦓢	而 而 而 犬 
𦓤	丿 未 
𦓥	耒 卩 
𦓧	耒 八 
𦓬	耒 平 
𦓯	耒 圭 
𦓰	耒 全 
𦓱	耒 各 
𦓳	耒 共 
𦓴	耒 肖 
𦓹	耒 來 
𦓺	耒 爭 
𦓻	耒 易 
𦓼	耒 昆 
𦓽	耒 委 
𦓾	耒 囷 
𦔂	耒 是 
𦔃	耒 英 
𦔄	耒 省 
𦔅	耒 突 
𦔆	耒 畐 
𦔈	耒 日 矢 
𦔉	耒 重 
𦔋	耒 茸 
𦔌	耒 耆 
𦔍	耒 尃 
𦔎	耒 畟 
𦔐	耒 員 
𦔓	耒 离 
𦔔	耒 曼 
𦔖	耒 連 
𦔗	耒 𢉖 
𦔛	耒 童 
𦔜	耒 異 
𦔠	耒 萆 
𦔥	耒 睪 
𦔦	耒 會 
𦔩	耒 麃 
𦔫	耒 翼 
𦔬	耒 瞿 
𦔭	耒 靡 
𦔮	耳 𠃊 
𦔯	八 耳 
𦔵	入 耳 
𦔷	耳 幺 
𦔸	耳 工 
𦔹	耳 叉 
𦔻	耳 口 
𦔼	耳 攴 
𦔿	耳 天 
𦕆	耳 牙 
𦕉	少 耳 
𦕏	耳 中 
𦕒	耳 占 
𦕓	工 几 耳 
𦕙	耳 句 
𦕠	耳 共 
𦕡	⺊ 耳 井 
𦕢	⺊ 耳 𡈼 
𦕰	耳 朵 
𦕵	耳 牢 
𦕷	耳 汞 
𦕸	耳 里 
𦕽	耳 伸 
𦖀	耳 孚 
𦖈	耳 奄 
𦖉	耳 罔 
𦖊	耳 奇 
𦖋	耳 垂 
𦖍	耳 果 
𦖎	耳 𢦟 
𦖐	耳 卸 
𦖝	刺 耳 
𦖞	昏 耳 
𦖢	耳 音 
𦖤	耳 星 
𦖦	耳 頁 
𦖧	耳 匽 
𦖩	耎 耳 
𦖬	耳 兮 皿 
𦖺	耳 兹 
𦖼	耳 骨 
𦖽	𤇾 耳 
𦖾	耳 兼 
𦖿	耳 荅 
𦗀	耳 真 
𦗁	真 耳 
𦗋	耳 容 
𦗍	耳 旁 
𦗐	耳 豙 
𦗑	耳 啇 
𦗓	耳 鹿 
𦗔	耳 巢 
𦗕	麻 耳 
𦗖	耳 翏 
𦗗	耳 習 
𦗛	耳 區 
𦗜	耳 從 
𦗟	耳 𢛳 
𦗡	耳 覃 
𦗢	耳 善 
𦗣	耳 黑 
𦗥	敝 耳 
𦗧	耳 答 
𦗨	耳 毳 
𦗮	耳 歮 
𦗳	耳 農 
𦗴	耳 當 
𦗵	耳 喿 
𦗻	耳 𮞬 
𦗼	僉 耳 
𦘊	耳 歷 
𦘌	錉 耳 
𦘍	耳 闋 
𦘔	聿 彡 
𦘝	𦘒 冂 心 卩 
𦘩	⺼ 八 
𦘪	⺼ 匕 
𦘲	⺼ 入 
𦘴	⺼ 乇 
𦘵	⺼ 一 九 
𦘶	⺼ 川 
𦘸	⺼ ⺊ 乙 
𦘹	⺼ 山 
𦘼	亐 月 
𦙀	⺼ 反 
𦙂	不 肉 
𦙄	凶 月 
𦙆	⺼ 氏 
𦙇	⺼ 冄 
𦙈	⺼ 卆 
𦙉	⺼ 又 几 
𦙊	火 月 
𦙋	⺼ 𠂉 𠤎 
𦙍	丿 幺 月 
𦙙	⺼ 水 
𦙜	⺼ 厄 
𦙝	⺼ 八 丁 
𦙧	肉 少 
𦙨	⺼ 弔 
𦙫	⺼ 正 
𦙮	⺼ 穴 
𦙯	代 月 
𦙱	⺼ 冊 
𦙴	⺼ 主 
𦙵	夗 月 
𦙸	⺼ 用 
𦙹	⺼ 尸 乂 
𦙺	加 月 
𦙻	⺼ 一 火 
𦙿	⺼ 兄 
𦚈	⺼ 石 
𦚊	⺼ 号 
𦚏	立 月 
𦚐	⺼ 它 
𦚓	肉 半 
𦚙	𠆢 士 肉 
𦚝	⺼ 水 ⺀ 
𦚞	⺼ 匡 
𦚟	⺼ 𦣝 
𦚡	⺼ 血 
𦚢	⺼ 㫐 
𦚣	⺼ 艮 
𦚥	⺼ 缶 
𦚦	⺼ 丞 
𦚧	⺼ 旬 
𦚨	㓞 肉 
𦚩	⺼ 朵 
𦚫	⺼ 士 大 
𦚸	⺼ 亘 
𦛅	肉 安 
𦛆	丞 肉 
𦛊	⺼ 存 
𦛏	⺼ 大 土 
𦛐	⺼ 𠂬 
𦛓	⺼ 𦥑 
𦛔	⺼ 𭻾 
𦛕	⺼ 劫 
𦛖	⺼ 耴 
𦛗	⺼ 呂 
𦛘	⺼ 赤 
𦛙	⺼ 成 
𦛚	⺼ 內 口 
𦛜	⺼ 含 
𦛝	余 肉 
𦛞	⺼ 邑 
𦛟	⺼ 更 
𦛠	⺼ 圼 
𦛢	⺼ 囯 
𦛣	⺼ 走 
𦛤	⺼ 㒵 
𦛧	⺼ 夂 火 
𦛨	⺼ 劳 
𦛯	石 又 月 
𦛰	⺼ 迄 
𦛱	⺼ 谷 
𦛲	⺼ 角 
𦛹	𢦒 肉 
𦜁	肉 夆 
𦜃	⺼ 旲 
𦜄	⺼ 日 夂 
𦜆	⺼ 函 
𦜇	⺼ 屈 
𦜊	⺼ 罙 
𦜋	⺼ 制 
𦜍	⺼ 放 
𦜎	⺼ 承 
𦜏	⺼ 戾 
𦜐	⺼ 官 
𦜒	⺼ 一 𠔁 夂 
𦜓	⺼ 欣 
𦜖	⺼ 亞 
𦜛	⺼ 戶 勼 
𦜜	臤 肉 
𦜝	⺼ 斉 
𦜟	⺼ 丶 否 
𦜭	⺼ 奔 
𦜯	⺼ 屯 灬 
𦜰	⺼ 卓 
𦜱	⺼ 八 虫 
𦜲	⺼ 侌 
𦜴	股 月 
𦜷	⺼ 𢘆 
𦜸	⺼ 𡧘 
𦝒	⺼ 取 
𦝔	⺼ 知 
𦝖	⺼ 𦙃 
𦝚	⺼ 盈 
𦝛	⺼ 韋 
𦝝	⺼ 奐 
𦝞	⺼ 亭 
𦝟	⺼ 厘 
𦝢	⺼ 癸 
𦝣	⺼ 客 
𦝤	⺼ 並 
𦝥	⺼ 臿 
𦝧	⺼ 甚 
𦝨	⺼ 皆 
𦝪	⺼ 垔 
𦝬	⺼ 突 
𦝭	帥 ⺝ 
𦝮	⺼ 昬 
𦝰	⺼ 怱 
𦝳	⺼ 狊 
𦝴	⺼ 𠆢 镸 
𦝷	⺼ 屏 
𦞁	⺼ 哉 
𦞂	⺼ 荅 
𦞇	⺼ 禹 
𦞈	⺼ 侯 
𦞌	⺼ 恒 
𦞕	⺼ 矦 
𦞖	⺼ 看 
𦞗	⺼ ⺫ 厷 
𦞙	⺼ 鬼 
𦞚	⺼ 屑 
𦞝	⺼ 氣 
𦞞	⺼ 圅 
𦞟	⺼ 𥁑 
𦞡	⺼ 邕 
𦞢	⺼ 圂 
𦞣	⺼ 蚤 
𦞤	⺼ 宰 
𦞥	⺼ 𡌥 
𦞦	⺼ 隺 
𦞨	⺼ 宮 
𦞫	𡨄 月 
𦞬	⺼ 䖍 
𦞭	⺼ 窊 
𦞱	肉 鬼 
𦞲	⺼ 蚩 
𦞽	⺼ 骨 
𦟀	亡 口 ⺼ 丮 
𦟁	囧 月 亡 
𦟂	⺼ 迷 
𦟃	⺼ 牂 
𦟄	⺼ 桑 
𦟐	⺼ 馬 
𦟓	⺼ 㞋 ⺝ 
𦟔	⺼ 致 
𦟕	⺼ 厂 昏 
𦟘	⺼ 寅 
𦟙	⺼ 𤉄 
𦟛	⺼ 庸 
𦟜	⺼ 責 
𦟞	⺼ 臯 
𦟟	⺼ 麻 
𦟠	⺼ 戚 
𦟣	⺼ 𡕩 
𦟤	⺼ 羞 
𦟧	⺼ 𦣞 𠮛 
𦟮	⺼ 莽 
𦟰	⺼ 虘 
𦟱	⺼ 宿 
𦟲	問 ⺝ 
𦟳	⺼ 巢 
𦟾	⺼ 區 
𦠁	炙 束 
𦠄	⺼ 幾 
𦠅	⺼ 尋 
𦠆	⺼ 巽 
𦠇	⺼ 曾 
𦠉	⺼ 壹 
𦠎	⺼ 猋 
𦠒	厥 ⺝ 
𦠓	厤 ⺝ 
𦠛	⺼ 替 
𦠜	⺼ 華 
𦠞	敝 ⺼ 
𦠟	⺼ 山 一 巿 斤 
𦠠	⺼ 山 屮 二 斤 
𦠢	⺼ 就 
𦠣	⺼ 𰕎 
𦠦	⺼ 疏 
𦠪	㫺 肉 
𦠷	囱 胥 
𦠸	⺼ 袲 
𦠹	炙 炙 
𦠺	炙 昆 
𦠻	⺼ 費 
𦠾	⺼ 戢 
𦠿	⺼ 䪞 
𦡂	⺼ 董 
𦡃	⺼ 吅 里 
𦡄	⺼ 都 
𦡅	⺼ 刑 酉 
𦡆	⺼ 窟 
𦡉	盟 月 
𦡕	⺼ 雹 
𦡖	歲 ⺼ 
𦡙	⺼ 𡕰 
𦡨	林 ⺝ 皮 
𦡪	⺼ 豋 
𦡫	⺼ 義 
𦡭	𦥑 冖 与 肉 
𦡱	⺼ 翟 
𦡲	⺼ 寧 
𦡴	⺼ 壽 
𦡵	⺼ 慁 
𦡷	⺼ 對 
𦡹	⺼ 㬎 
𦡺	賏 ⺝ 
𦡻	⺼ 凴 
𦡼	疑 肉 
𦡽	⺼ 九 黃 
𦢂	⺼ 业 美 
𦢆	賏 肉 
𦢊	⺼ 暴 
𦢎	⺼ 廣 
𦢏	⺼ 畾 
𦢐	⺼ 艹 𰥍 厶 
𦢙	⺼ 韯 
𦢧	⺼ 瞢 
𦢩	⺼ 蕭 
𦢯	⺼ 興 
𦢱	君 月 羊 凡 
𦢺	⺼ ⺫ 焦 
𦢻	仌 䧹 肉 
𦢿	⺼ 巂 
𦣀	⺼ 聶 
𦣂	⺼ 豐 
𦣄	𣎆 革 
𦣇	⺼ 羅 
𦣋	⺼ 䜌 
𦣍	⺼ 羹 
𦣏	䜌 ⺝ 
𦣒	⺼ 矍 
𦣖	𣎆 晶 
𦣘	⺼ 囊 
𦣛	⺼ 戀 
𦣜	⺼ 䀠 爿 疾 
𦣢	臣 巿 
𦣥	臣 必 
𦣧	臣 𠕋 
𦣨	臣 任 
𦣯	臣 叚 
𦣱	臣 責 
𦣴	臤 睘 
𦣸	毚 監 
𦣹	凵 人 二 
𦣺	自 丨 
𦣾	自 兀 
𦤂	自 殳 
𦤇	自 反 
𦤈	自 从 
𦤊	自 丑 
𦤋	𠃜 自 
𦤎	自 本 
𦤕	臭 夬 
𦤘	亯 自 
𦤙	臬 出 
𦤚	臭 犮 
𦤝	自 穴 𠔽 
𦤟	囟 臭 
𦤢	洎 侖 
𦤣	孛 臭 
𦤦	臭 曷 
𦤧	臭 柰 
𦤨	臭 昷 
𦤪	曷 臭 
𦤫	自 鼻 
𦤬	臭 害 
𦤸	川 至 
𦤻	瓜 至 
𦤽	至 尼 
𦥁	𦉴 至 
𦥂	圭 冖 至 
𦥈	⺷ 冖 至 
𦥉	室 吾 
𦥊	孫 至 
𦥍	至 夏 
𦥎	執 至 
𦥐	枲 致 
𦥖	臼 ㇇ 丨 
𦥚	臼 丨 丂 
𦥝	爪 臼 
𦥣	臼 尤 
𦥤	𦥔 万 
𦥦	臼 末 
𦥬	臼 乍 
𦥭	屰 臼 
𦥰	臼 光 
𦥱	臼 夕 巾 
𦥻	臼 垂 
𦦃	旨 兒 
𦦄	昍 臼 
𦦅	臼 奏 
𦦌	舀 召 
𦦑	𦥯 分 
𦦕	臿 夾 
𦦗	𦥯 木 
𦦘	臿 疌 
𦦛	𦥯 丘 
𦦢	敞 臼 
𦦣	臼 最 
𦦩	𦥑 缶 夗 
𦦫	𦥑 𦥑 一 八 亏 
𦦯	𦥯 𦈢 
𦦱	舂 臿 
𦦲	𦥑 与 𦥑 一 八 
𦦹	凵 丵 殳 臼 
𦦺	舂 𠷎 
𦦽	䜌 臼 
𦦿	嬰 兒 
𦧈	舌 今 
𦧉	舌 支 
𦧋	舌 牛 
𦧍	爪 舌 
𦧏	舌 井 
𦧐	𠫘 舌 
𦧒	舌 古 
𦧔	⾆ 瓜 
𦧖	舌 㐁 
𦧘	肉 舌 
𦧙	舌 朱 
𦧛	舌 合 
𦧝	舌 延 
𦧞	舌 呇 
𦧟	舌 沓 
𦧠	帛 舌 
𦧡	炎 舌 
𦧢	舌 𣏋 
𦧤	舌 𣏼 
𦧥	沓 舌 
𦧬	彖 舌 
𦧮	舌 害 
𦧯	舌 息 
𦧱	舌 習 
𦧴	舌 單 
𦧸	舍 巽 
𦧼	舌 闌 
𦨆	北 穴 瓦 粦 
𦨇	舟 乙 
𦨈	舟 人 
𦨉	舟 刂 
𦨋	舟 乃 
𦨍	舟 丁 
𦨎	舟 乇 
𦨖	舟 少 
𦨙	舟 日 
𦨚	舟 犬 
𦨜	舟 戈 
𦨡	舟 弗 
𦨢	舟 氐 
𦨣	舟 召 
𦨤	永 舟 
𦨦	加 舟 
𦨩	舟 龙 
𦨬	舟 永 
𦨭	舟 皮 
𦨯	舟 ⾆ 
𦨰	舟 邛 
𦨲	舟 氾 
𦨳	舟 吴 
𦨴	舟 同 
𦨵	舟 行 
𦨾	舟 亨 
𦩄	舟 𡉵 
𦩈	舟 矣 
𦩋	舟 非 
𦩌	舟 疌 
𦩍	舟 周 
𦩏	舟 隹 
𦩕	舟 虎 
𦩖	舟 卑 
𦩘	舟 定 
𦩜	舟 咅 
𦩝	舟 胃 
𦩞	舟 俞 
𦩠	舟 星 
𦩡	舟 畐 
𦩢	舟 咸 
𦩣	舟 契 
𦩤	舟 突 
𦩧	𡥦 舟 
𦩩	舟 龹 女 
𦩫	舟 龹 巾 
𦩬	舟 威 
𦩭	舟 思 
𦩯	舟 尸 曲 
𦩱	舟 龹 土 
𦩲	舟 酋 
𦩴	舟 豈 
𦩵	舟 兼 
𦩷	舟 冓 
𦩸	舟 弱 
𦩻	𠦝 𠂉 舟 
𦩼	舟 貢 
𦩿	舟 𦥛 
𦪀	舟 唐 
𦪇	舟 鹿 
𦪈	敖 舟 
𦪊	舟 戚 
𦪋	舟 羞 
𦪍	舟 止 豆 
𦪑	舟 發 
𦪒	舟 貴 
𦪔	舟 敦 
𦪕	舟 尞 
𦪖	舟 番 
𦪗	舟 黃 
𦪘	舟 厥 
𦪙	舟 翕 
𦪚	舟 尊 
𦪛	舟 堯 
𦪜	舟 叅 
𦪝	舟 絭 
𦪠	舟 華 
𦪡	舟 虚 
𦪣	單 舟 
𦪧	舟 敢 
𦪪	舟 竹 夆 
𦪫	舟 粲 
𦪬	舟 歇 
𦪭	舟 達 
𦪱	臣 妻 舟 
𦪶	舟 䗍 
𦪹	般 禾 血 
𦪽	舟 龍 
𦪾	舟 歷 
𦪿	龍 舟 
𦫀	舟 龹 馬 
𦫃	舟 霝 
𦫈	舟 蠡 
𦫊	舟 靈 
𦫎	耒 艮 
𦫔	癶 色 
𦫕	未 色 
𦫖	色 白 
𦫙	白 色 
𦫡	其 色 
𦫤	色 頁 
𦫪	窊 色 
𦫫	翁 色 
𦫭	眞 色 
𦫮	員 色 
𦫯	熏 色 
𦫰	夢 色 
𦫳	艹 丨 
𦫶	艹 丩 
𦫻	艹 亻 
𦫼	艹 了 
𦬁	艹 才 
𦬂	艹 兀 
𦬃	艹 乇 
𦬄	艹 刃 
𦬅	艹 口 
𦬆	艹 亾 
𦬔	艹 爪 
𦬕	艹 中 
𦬖	艹 仇 
𦬗	艹 戈 
𦬘	艹 公 
𦬙	艹 仆 
𦬚	艹 互 
𦬛	艹 丏 
𦬞	艹 天 
𦬢	艹 卅 
𦬣	艹 冂 又 
𦬸	艹 术 
𦬹	艹 旦 
𦬺	艹 兄 
𦬻	艹 奴 
𦬾	艹 玄 
𦭁	艹 㘝 
𦭈	艹 瓦 
𦭉	艹 囗 九 
𦭘	艹 夘 
𦭟	艹 他 
𦭡	艹 司 
𦭥	艹 㐌 
𦭭	艹 邛 
𦭮	艹 㐁 
𦭯	艹 𠃊 丙 
𦭰	艹 汝 
𦭲	艹 弜 
𦭳	艹 羽 
𦭴	艹 州 
𦭵	艹 羊 
𦭶	艹 先 
𦭷	艹 牟 
𦭸	艹 舟 
𦭹	艹 灰 
𦭺	艹 丩 丩 丩 
𦭻	艹 臼 
𦭼	艹 𠬪 
𦮁	𦬇 𠃏 
𦮃	𦫳 北 
𦮐	艹 幺 大 
𦮑	艹 彐 口 
𦮯	艹 刖 
𦮶	艹 吻 
𦮷	艹 貝 
𦮸	艹 矣 
𦮹	艹 夿 
𦮺	艹 私 
𦮻	艹 肙 
𦮼	艹 忌 
𦮾	艹 抐 
𦯀	芬 土 
𦯅	艹 序 
𦯆	艹 戼 
𦯉	艹 伯 
𦯌	艹 亾 心 
𦯍	艹 耴 
𦯏	艹 女 𡯄 
𦯐	艹 亻 召 
𦯑	艹 皁 
𦯒	艹 仰 
𦯕	艹 宋 
𦯖	艹 圼 
𦯛	𦬇 𠔿 
𦯣	艹 伹 
𦯪	艹 杓 
𦯫	艹 𣲑 
𦯬	艹 佘 
𦯰	艹 厂 石 
𦰏	艹 条 
𦰖	艹 拋 
𦰗	艹 𰅲 
𦰘	艹 厎 
𦰙	𦬇 比 
𦰛	艹 汾 
𦰥	艹 龵 ⻏ 
𦰪	艹 泅 
𦰫	艹 泥 
𦰬	艹 帛 
𦰭	艹 迍 
𦰯	艹 始 
𦰰	艹 姁 
𦰱	艹 尚 
𦰲	艹 盱 
𦰳	艹 枒 
𦰴	艹 弥 
𦰸	艹 歹 心 
𦰹	艹 受 
𦰺	艹 阜 
𦰽	艹 披 
𦰾	艹 㚿 
𦱀	艹 育 
𦱁	艹 弦 
𦱂	艹 或 
𦱃	艹 盂 
𦱄	艹 狐 
𦱅	艹 居 
𦱆	艹 陀 
𦱇	艹 空 
𦱊	艹 爭 
𦱋	艹 盲 
𦱌	艹 岡 
𦱒	艹 牧 
𦱓	苗 廾 
𦱔	艹 肶 
𦱖	艹 附 
𦱜	艹 䄪 
𦱠	茻 丩 
𦱣	芒 皿 
𦱰	艹 寺 刂 
𦱱	𦬇 㠯 
𦱲	艹 尸 冉 
𦱵	艹 囗 矢 
𦱷	艹 不 灬 
𦲫	艹 拂 
𦲯	艹 𡕢 
𦲰	艹 𥃳 
𦲱	𦬇 付 
𦲷	艹 泣 
𦳁	艹 秏 
𦳃	艹 耶 
𦳄	艹 便 
𦳇	艹 恬 
𦳈	艹 毗 
𦳋	艹 㕟 
𦳌	艹 急 
𦳏	艹 柤 
𦳐	艹 柰 
𦳑	艹 某 
𦳓	艹 鳬 
𦳔	艹 度 
𦳗	艹 省 
𦳘	艹 查 
𦳙	艹 致 
𦳚	艹 是 
𦳛	艹 軌 
𦳜	苠 日 
𦳝	艹 昜 
𦳞	艹 拜 
𦳟	艹 巾 羊 
𦳡	艹 𤓿 
𦳢	艹 胃 
𦳣	荀 大 
𦳥	艹 眇 
𦳦	艹 哉 
𦳧	艹 斿 
𦳩	艹 囿 
𦳫	艹 𮂸 
𦳬	艹 𡇞 
𦳭	艹 𫐣 
𦳮	苜 木 
𦳲	莖 刂 
𦳳	艹 𦘔 
𦳶	芒 虫 
𦳷	艹 酋 
𦳹	艹 女 九 勺 
𦳺	艹 辶 犮 
𦳽	艹 禾 允 
𦳾	艹 穴 允 
𦳿	艹 木 矢 
𦴀	艹 龶 目 
𦴉	艹 牙 瓜 
𦴊	艹 殃 
𦴌	艹 㝖 
𦴍	艹 虵 
𦴎	艹 冖 子 殳 
𦴑	艹 柑 
𦴔	苂 目 
𦴚	艹 迢 
𦵟	艹 邿 
𦵡	艹 宮 
𦵣	艹 圂 
𦵦	艹 俶 
𦵧	艹 狼 
𦵩	艹 酒 
𦵪	艹 朿 攵 
𦵫	艹 索 
𦵬	艹 祚 
𦵭	艹 挼 
𦵯	艹 害 
𦵱	艹 屑 
𦵴	艹 桀 
𦵵	艹 𠧴 
𦵷	艹 冓 
𦵸	艹 耿 
𦵹	艹 剡 
𦵼	艹 郡 
𦵽	艹 晃 
𦵾	艹 脊 
𦵿	艹 剖 
𦶀	艹 烏 
𦶂	艹 挹 
𦶅	艹 迺 
𦶇	艹 毦 
𦶈	艹 耳 冄 
𦶊	艹 涄 
𦶋	艹 扇 
𦶌	艹 凋 
𦶍	艹 立 瓜 
𦶏	艹 陮 
𦶐	艹 恐 
𦶑	艹 𦐇 
𦶓	艹 栱 
𦶕	艹 書 
𦶙	艹 桓 
𦶚	艹 粉 
𦶟	艹 热 
𦶲	艹 完 女 
𦷙	艹 禾 占 
𦷝	艹 勹 小 勹 小 
𦷦	艹 癶 石 
𦷲	艹 爫 糸 
𦷳	艹 宀 豆 
𦷴	艹 送 
𦷵	艹 女 助 
𦷷	艹 𨒨 
𦷸	茹 水 
𦷹	𦭝 𠃌 日 
𦷻	艸 忄 忄 攴 
𦷽	艹 郚 
𦷿	艹 逌 
𦸁	艹 淡 
𦸂	艹 深 
𦸆	艹 㠱 
𦸈	艹 舌 瓜 
𦸉	艹 𤫶 
𦸏	艹 崔 
𦸐	艹 陸 
𦸓	艹 桼 
𦸔	艹 彫 
𦸗	艹 戚 
𦸘	艹 戛 
𦸙	艹 郵 
𦸚	艹 習 
𦸛	艹 巢 
𦸡	艹 覓 
𦸢	艹 屚 
𦸣	艹 庳 
𦸪	艹 氵 非 
𦸮	艹 减 
𦸯	莘 木 
𦸰	艹 產 
𦸱	艹 婦 
𦸶	出 草 
𦸷	艹 糸 瓜 
𦸺	艹 㭰 
𦹫	艹 㹿 
𦹽	艹 𭚽 
𦺀	艹 木 𠫔 夫 
𦺆	艹 臯 
𦺇	艹 氵 毒 
𦺉	艹 傅 
𦺊	艹 睆 
𦺋	艹 㛮 
𦺌	艹 氵 宀 八 𠆢 夊 
𦺍	艹 湔 
𦺎	艹 䏽 
𦺐	艹 殘 
𦺑	艹 咅 毛 
𦺒	艹 婺 
𦺓	艹 朝 
𦺔	艹 殽 
𦺖	艹 矞 
𦺗	艹 舒 
𦺘	艹 減 
𦺙	艹 犂 
𦺛	艹 猭 
𦺜	艹 勞 
𦺝	艹 寍 
𦺞	艹 訶 
𦺟	艹 壺 
𦺠	艹 觚 
𦺡	艹 掌 
𦺢	艹 結 
𦺣	艹 項 
𦺥	艹 都 
𦺦	艹 寒 
𦺨	艹 象 
𦺩	艹 㦸 
𦺪	艹 稌 
𦺫	艹 硠 
𦺬	艹 幾 
𦺭	艹 㑴 
𦺰	艹 絛 
𦺱	艹 貲 
𦺲	苑 貝 
𦺳	艹 𠶷 
𦺴	艹 集 
𦺵	菆 木 
𦺷	艹 兟 
𦺸	艹 粦 
𦺹	艹 聊 
𦺻	艹 散 
𦺽	艹 晻 
𦺾	艹 渜 
𦻀	艹 徥 
𦻁	艹 欿 
𦻅	艹 䨿 
𦻐	艹 焯 
𦼆	艹 麦 玉 
𦼇	艹 惡 
𦼈	菆 灬 
𦼉	艹 萑 
𦼊	艹 棱 
𦼋	艹 木 彔 
𦼎	艹 舟 舟 
𦼏	艹 曾 
𦼓	艹 琰 
𦼗	艹 犀 
𦼡	艹 幺 巾 𢁙 
𦼢	艹 𣂫 
𦼧	艹 𬯁 乂 
𦼪	艹 楙 
𦼫	艹 豦 
𦼭	艹 榑 
𦼮	艹 幹 
𦼰	艹 楬 
𦼱	艹 雋 
𦼲	艹 當 
𦼳	艹 腸 
𦼴	艹 楊 
𦼵	艹 毼 
𦼷	艹 𣪠 
𦼹	艹 稟 
𦼻	艹 溦 
𦼿	艹 頓 
𦽀	艹 午 頁 
𦽁	艹 經 
𦽂	艹 稑 
𦽃	艹 片 扁 
𦽄	艹 殿 
𦽅	艹 閜 
𦽇	艹 腱 
𦽊	艹 嗣 
𦽋	艹 鉤 
𦽎	艹 祿 
𦽏	艹 鳧 
𦽐	艹 毀 
𦽒	艹 賊 
𦽔	艹 禁 
𦽕	艹 犭 臣 犬 
𦽖	艹 目 囷 
𦽜	艹 宀 分 臼 
𦽞	艹 韋 元 
𦽟	艹 遍 
𦽤	艹 言 𠂢 
𦽫	艹 感 
𦽬	艹 癶 㐄 㐄 
𦽭	茤 臼 
𦽮	艹 媻 
𦾏	華 甲 
𦾑	艹 剽 
𦾕	艹 腷 
𦾘	艹 女 宀 火 夕 
𦾙	艹 扌 𠦃 夲 
𦾚	艹 虞 
𦾛	艹 暐 
𦾝	蒼 山 
𦾞	艹 盝 
𦾩	艹 䧟 
𦾫	艹 穀 
𦾬	艹 摺 
𦾭	艹 牓 
𦾮	艹 榦 
𦾱	艹 摷 
𦾲	艹 兾 
𦾳	艹 㼲 
𦾴	艹 緐 
𦾵	艹 榮 
𦾶	艹 漸 
𦾷	艹 漻 
𦾸	艹 端 
𦾹	艹 酸 
𦾺	艹 銚 
𦾽	艹 遝 
𦾾	艹 遙 
𦾿	艹 精 
𦿀	艹 禾 者 
𦿁	艹 稫 
𦿂	艹 鳶 
𦿃	艹 𨲆 
𦿅	艹 凴 
𦿆	艹 碭 
𦿇	艹 𫑨 
𦿊	艹 𧇄 
𦿋	艹 朅 
𦿌	艹 㬎 
𦿍	艹 僕 
𦿏	艹 夢 
𦿐	艹 𢧵 
𦿓	艹 毄 
𦿖	艹 塶 
𧀄	艹 畼 
𧀅	𦭝 戈 禾 
𧀇	艹 囗 細 
𧀊	艹 綵 
𧀌	艹 漱 
𧀔	艹 𧳑 
𧀕	艹 ⻖ 辶 辛 
𧀗	艹 耒 甾 
𧀘	艹 㥽 
𧀙	艹 耿 灬 
𧀚	艹 禾 司 火 
𧀠	艹 緹 
𧀡	艹 潐 
𧀢	艹 蹀 
𧀣	艹 誰 
𧀤	艹 齒 
𧀥	艹 憂 
𧀦	艹 魯 
𧀨	艹 巤 
𧀩	艹 賜 
𧀬	艹 膝 
𧀭	艹 樊 
𧀮	艹 敷 
𧀯	艹 審 
𧀰	艹 蹄 
𧀱	蔕 心 
𧀲	艹 閱 
𧀴	艹 膚 
𧀵	艹 槧 
𧀶	艹 士 冖 田 厶 龰 
𧀹	艹 遮 
𧀺	艹 頡 
𧀻	艹 儋 
𧀼	艹 辥 
𧀿	艹 鄭 
𧁃	艹 稸 
𧁊	艹 眼 心 
𧁋	艹 慜 
𧁾	艹 婁 瓜 
𧁿	艹 獨 
𧂀	艹 豸 頁 
𧂁	艹 戰 
𧂂	艹 錢 
𧂃	艹 頷 
𧂄	艹 閻 
𧂅	艹 穇 
𧂆	艹 劒 
𧂇	蕁 爻 
𧂈	艹 操 
𧂉	艹 皤 
𧂋	艹 憑 
𧂍	艹 選 
𧂏	艹 遼 
𧂐	艹 積 
𧂒	艹 燋 
𧂔	艹 縠 
𧂙	艹 潟 
𧂛	艹 甍 
𧂜	艹 窶 
𧂞	艹 𰟚 
𧂠	艹 遺 
𧂡	蕑 心 
𧂦	艹 𣚊 
𧂨	蒂 足 
𧂩	艹 𦃐 
𧃏	艹 歜 
𧃐	艹 蹢 
𧃑	艹 鍵 
𧃒	艹 縷 
𧃔	艹 擢 
𧃘	艹 缶 虘 
𧃙	艹 韓 
𧃚	艹 ⺼ 遀 
𧃛	艹 購 
𧃞	艹 冀 
𧃠	艹 甚 青 
𧃣	艹 𥊽 
𧃨	艹 孺 
𧃩	艹 犭 疑 
𧃪	多 艹 問 
𧃮	艹 燐 
𧃱	艹 𤕦 
𧃹	華 世 木 
𧄍	艹 翹 
𧄎	艹 䌛 
𧄏	艹 覆 
𧄐	艹 雙 
𧄑	艹 繢 
𧄒	艹 瞿 
𧄓	壴 董 
𧄔	艹 儲 
𧄚	艹 釐 
𧄛	艹 鞫 
𧄜	艹 繠 
𧄠	艹 枼 枼 
𧄤	艹 嚚 
𧄸	艹 舋 
𧄹	艹 識 
𧄺	艹 顛 
𧄻	艹 瀝 
𧄽	艹 贊 
𧄿	艹 羸 
𧅀	艹 鏨 
𧅃	艹 爊 
𧅆	艹 繭 
𧅈	艹 禾 翟 
𧅋	艹 𦝠 艮 
𧅖	艹 鶪 
𧅗	艹 黨 
𧅘	艹 羺 
𧅚	艹 矍 
𧅮	艹 蠡 
𧅯	艹 𪅆 
𧅰	艹 護 
𧅲	艹 𡈹 
𧅺	艹 囊 
𧅻	艹 𪅀 
𧆂	艹 䜟 
𧆈	艹 𩕺 
𧆉	雚 凡 糸 
𧆊	艹 鱉 
𧆏	艹 矕 
𧆐	艹 贛 
𧆑	艹 靃 
𧆓	艹 麤 
𧆘	艹 囗 木 木 木 木 木 木 木 木 木 
𧆜	虍 亐 
𧆡	几 虎 
𧆢	虎 丩 
𧆣	虍 凷 
𧆥	虍 甲 
𧆦	乞 虎 
𧆮	𧆞 丩 
𧆯	虎 才 
𧆰	虎 子 
𧆷	虎 公 
𧆸	虎 灬 
𧆹	虎 心 
𧆺	令 虎 
𧆻	虎 古 
𧆼	虎 冬 
𧇄	虍 甾 
𧇈	䖍 且 
𧇌	虎 同 
𧇍	缶 虎 
𧇎	虎 合 
𧇒	虎 𭟰 
𧇓	虎 兌 
𧇙	虎 男 
𧇚	虎 伯 
𧇛	虎 寽 
𧇜	臤 虎 
𧇝	叔 虎 
𧇞	虎 羌 
𧇟	虎 周 
𧇠	虛 亢 
𧇡	處 古 
𧇥	虎 林 
𧇦	法 虎 
𧇮	虎 和 
𧇯	虎 季 
𧇰	虎 忽 
𧇱	虎 咸 
𧇶	虎 春 
𧇷	曷 虎 
𧇸	虎 秋 
𧇹	虎 侯 
𧇼	号 䖒 
𧇽	虍 異 
𧇿	豦 且 
𧈁	兼 虍 人 
𧈄	虎 夏 
𧈅	𡭽 虎 
𧈈	虎 巢 
𧈌	叀 殳 虎 
𧈍	單 虎 
𧈑	虎 𣪠 
𧈔	虍 魯 
𧈖	𣪠 虎 
𧈗	𣪠 虎 
𧈙	虎 壽 
𧈚	䖒 㿾 
𧈜	虎 騰 
𧈝	虫 乙 
𧈞	𠃊 虫 
𧈦	乃 虫 
𧈧	厶 虫 
𧈪	屮 虫 
𧈭	虫 兀 
𧈯	虫 亐 
𧈹	大 虫 
𧈻	虫 殳 
𧈼	虫 片 
𧈽	虫 厷 
𧈾	虫 火 
𧈿	虫 冈 
𧉀	虫 止 
𧉁	气 虫 
𧉂	虫 天 
𧉃	虫 允 
𧉄	虫 丏 
𧉅	虫 尹 
𧉆	虫 龰 
𧉇	尣 虫 
𧉈	虫 不 
𧉊	父 虫 
𧉍	虫 尐 
𧉎	虫 ⺝ 
𧉑	虫 太 
𧉓	木 虫 
𧉗	元 虫 
𧉛	虫 𢆰 
𧉞	虫 宁 
𧉟	虫 台 
𧉡	虫 宀 儿 
𧉢	虫 穴 
𧉣	虫 玉 
𧉤	虫 弁 
𧉥	北 虫 
𧉧	虫 去 
𧉩	虫 布 
𧉪	加 虫 
𧉫	虫 㘝 
𧉭	奴 虫 
𧉮	虫 㐌 
𧉲	虫 𠂆 干 
𧉹	虫 札 
𧊇	代 虫 
𧊏	虫 亥 
𧊒	次 虫 
𧊔	行 虫 
𧊕	虫 戎 
𧊖	虫 式 
𧊘	虫 夸 
𧊙	虫 旨 
𧊚	虫 同 
𧊛	虫 后 
𧊜	虫 屰 
𧊝	艹 𠂇 虫 
𧊞	虫 刑 
𧊟	如 虫 
𧊠	虫 㬰 
𧊣	虫 曳 
𧊤	虫 亦 
𧊥	虫 戍 
𧊦	虫 缶 
𧊧	合 虫 
𧊬	艹 又 虫 
𧊭	虫 因 
𧊯	永 虫 
𧊱	虫 朶 
𧊽	虫 行 
𧊾	米 虫 
𧋉	虫 谷 
𧋊	沙 虫 
𧋍	虫 折 
𧋎	虫 里 
𧋏	虫 岌 
𧋐	虫 束 
𧋑	虫 更 
𧋒	虫 赤 
𧋓	虫 告 
𧋔	汞 虫 
𧋕	虫 困 
𧋖	虫 耴 
𧋗	氏 虫 土 
𧋘	虫 弟 
𧋚	仌 厂 䖝 
𧋠	豕 虫 
𧋡	虫 𡆴 
𧋢	虫 孛 
𧋣	虫 𠯑 
𧋱	虫 男 
𧋲	亠 北 虫 
𧌁	攸 虫 
𧌃	虫 妾 
𧌄	虫 奄 
𧌅	虫 受 
𧌆	虫 空 
𧌇	虫 朋 
𧌉	虫 坴 
𧌊	虫 夜 
𧌋	虫 卸 
𧌌	⺼ 尤 虫 
𧌍	虫 彔 
𧌎	虫 典 
𧌏	虫 沓 
𧌐	刺 虫 
𧌑	虫 屈 
𧌓	虫 阜 
𧌔	枝 虫 
𧌖	虫 舍 
𧌗	虫 取 
𧌘	服 虫 
𧌙	雨 虫 
𧌚	虫 炅 
𧌝	𤆍 䖝 
𧌞	虫 礻 卩 
𧌠	卑 虫 
𧌢	糸 𠆢 虫 
𧌣	刀 䖵 
𧌧	虫 虍 丁 
𧌴	虫 祁 
𧌻	松 虫 
𧌽	虫 㡀 
𧌾	䖵 丁 
𧌿	版 虫 
𧍀	勹 䖵 
𧍁	虫 庚 
𧍂	虫 又 有 
𧍃	虫 非 
𧍒	虫 耑 
𧍓	帥 虫 
𧍔	虫 要 
𧍕	虫 卻 
𧍖	虫 省 
𧍘	虫 幽 
𧍙	范 虫 
𧍜	虫 癸 
𧍝	虫 帝 
𧍟	茅 虫 
𧍠	虫 苶 
𧍢	衍 虫 
𧍣	苗 虫 
𧍥	虫 畏 
𧍨	吅 大 虫 
𧍩	虫 吉 夨 
𧍪	虫 禺 
𧍫	虫 韋 
𧍬	虫 弇 
𧍭	虫 泉 
𧍮	虫 扃 
𧍯	虫 風 
𧍰	虫 㚅 
𧍱	虫 室 
𧍲	虫 便 
𧍴	虫 柬 
𧍵	胡 虫 
𧍶	虫 律 
𧍸	夂 䖵 
𧍿	虫 殄 
𧎃	𠤕 𠆢 虫 
𧎄	虫 矛 攵 
𧎕	北 蚕 
𧎖	虫 ⺫ 水 
𧎗	科 虫 
𧎘	虫 衍 
𧎙	虫 𠨚 
𧎡	虫 宮 
𧎢	虫 貣 
𧎣	虫 茸 
𧎤	虫 孫 
𧎥	虫 扇 
𧎨	虫 屖 
𧎪	氏 䖵 
𧎭	射 虫 
𧎮	㕚 䖵 
𧎯	虫 缺 
𧎰	展 虫 
𧎱	巴 䖵 
𧎲	虫 丵 
𧎳	虫 索 
𧎴	虫 哲 
𧎵	虫 氣 
𧎷	虫 芻 
𧎸	虫 高 
𧎺	虫 哥 
𧎻	務 虫 
𧎾	虫 𡭴 
𧎿	疾 虫 
𧏂	虫 𠃊 圭 大 
𧏃	虫 丶 匡 大 
𧏆	臣 斗 虫 
𧏑	虫 竝 
𧏥	虫 𦮕 
𧏧	虫 畟 
𧏫	虫 殺 
𧏸	虫 啇 
𧏹	虫 豙 
𧏺	虫 區 
𧏻	虫 畢 
𧏽	虫 悘 
𧏾	匿 虫 
𧏿	虫 逐 
𧐁	虫 欶 
𧐂	⻞ 𠆢 虫 
𧐃	虫 隹 大 
𧐄	虫 欲 
𧐅	虫 虘 
𧐈	族 虫 
𧐉	知 干 虫 
𧐊	虫 張 
𧐋	虫 田 各 
𧐌	唯 虫 
𧐍	虫 舂 
𧐎	虫 覓 
𧐐	虫 責 
𧐒	虫 速 
𧐓	野 虫 
𧐔	虫 習 
𧐕	虫 專 
𧐖	虫 連 
𧐗	虫 旋 
𧐙	虫 務 
𧐟	虫 每 心 
𧐢	虫 毫 
𧐯	略 虫 
𧐰	𠕀 蜀 
𧐱	從 虫 
𧐲	虫 夂 ⺫ 巾 
𧐳	虫 𢉖 
𧐴	虫 宿 
𧑀	虫 巢 
𧑆	虫 童 
𧑇	虫 棃 
𧑈	虫 費 
𧑊	虫 景 
𧑋	虫 貴 
𧑌	虫 異 
𧑍	虫 華 
𧑎	祟 𧈡 
𧑐	虫 矞 
𧑑	虫 菶 
𧑒	虫 敦 
𧑓	虫 黍 
𧑔	虫 逮 
𧑕	虫 惡 
𧑖	朿 䖵 
𧑗	虫 甯 
𧑘	湯 虫 
𧑙	虫 就 
𧑚	虫 寒 
𧑜	虫 琵 
𧑝	掾 虫 
𧑡	虫 琶 
𧑤	朱 䖵 
𧑦	虫 隹 夬 
𧑧	蜇 石 
𧑨	㓞 䖵 
𧑫	虫 叅 
𧒀	虫 敝 
𧒂	𠂤 䖵 
𧒈	列 䖵 
𧒎	我 䖵 
𧒐	虫 广 夾 土 
𧒑	虫 鼠 
𧒓	虫 瑟 
𧒔	求 䖵 
𧒖	虫 過 
𧒗	虫 嗇 
𧒘	虫 𩰬 
𧒙	𠂤 一 䖵 
𧒚	艹 蝥 
𧒜	雷 虫 
𧒝	尸 龷 䖵 
𧒨	茧 虫 土 
𧒭	虫 遗 
𧒻	虫 觧 
𧒽	虫 雷 
𧒾	當 虫 
𧒿	虫 賊 
𧓀	𠆢 魚 虫 
𧓁	虫 愛 
𧓄	虫 辟 
𧓉	齊 虫 
𧓋	虫 𠪨 
𧓎	卑 䖵 
𧓏	虫 聚 
𧓐	㼲 虫 
𧓑	雨 䖵 
𧓓	虫 㡭 
𧓔	精 虫 
𧓕	東 䖵 
𧓖	肥 䖵 
𧓗	虫 歋 
𧓘	虫 團 
𧓧	虫 鼻 
𧓨	𧈟 䖵 
𧓩	虫 䝳 
𧓪	虫 銀 
𧓲	虫 養 
𧓴	虫 霆 
𧓸	虫 鄭 
𧓺	虫 寫 
𧓻	虫 慮 
𧓽	厂 蠆 
𧓿	茅 䖵 
𧔂	𡧷 䖵 
𧔅	螻 攴 
𧔖	虫 賣 
𧔝	虫 歷 
𧔞	原 䖵 
𧔡	展 䖵 
𧔣	虫 賴 
𧔤	縣 虫 
𧔥	虫 遺 
𧔦	虫 燕 
𧔧	逄 䖵 
𧔨	弔 蟲 
𧔩	艹 弔 䖵 
𧔪	頻 虫 
𧔬	虫 橐 
𧔭	丷 西 人 䖵 
𧔮	豈 䖵 
𧔳	留 䖵 
𧔴	艹 蟲 
𧔷	虫 暹 
𧔼	蟲 戈 
𧕃	虫 毚 
𧕄	虫 應 
𧕅	虫 霝 
𧕇	虫 鮮 
𧕉	虫 谿 
𧕋	虫 龠 
𧕌	略 䖵 
𧕍	虫 營 
𧕎	渠 䖵 
𧕐	曹 䖵 
𧕒	弗 蟲 
𧕓	虫 此 黽 
𧕙	畣 䖵 
𧕝	𫲽 ⺫ 䖵 
𧕞	魏 虫 
𧕟	虫 雙 
𧕡	虫 覆 
𧕤	貘 虫 
𧕥	虫 貘 
𧕦	單 䖵 
𧕧	𦥑 龱 䖵 
𧕨	虫 藏 
𧕮	虫 離 
𧕯	虫 麗 
𧕱	舝 䖵 
𧕲	雋 䖵 
𧕵	黽 䖵 
𧕸	騜 虫 
𧕺	虫 雔 凡 
𧕼	翽 虫 
𧕿	非 蟲 
𧖅	鼏 䖵 
𧖆	虫 闥 
𧖇	廱 虫 
𧖉	尸 㠭 䖵 
𧖑	彊 䖵 
𧖒	虫 囊 
𧖔	𨳌 蟲 
𧖕	𣬈 蟲 
𧖘	虫 攣 
𧖙	顯 虫 
𧖚	㯱 䖵 
𧖜	虫 靈 
𧖠	𮭘 虫 
𧖢	翽 䖵 
𧖨	血 丂 
𧖪	血 夕 
𧖬	㠪 血 
𧖮	血 日 
𧖴	𠂢 血 
𧖵	血 免 
𧖷	血 忍 
𧖸	囧 血 
𧖺	⺼ 冘 血 
𧖻	血 或 
𧖼	血 咎 
𧖿	血 昇 
𧗁	𦘔 血 
𧗆	艹 丞 血 
𧗈	血 辱 
𧗋	血 參 
𧗌	血 虖 
𧗎	菹 血 
𧗏	血 貴 
𧗒	幾 血 
𧗓	幾 血 
𧗖	厭 血 
𧗦	行 开 
𧗩	不 行 
𧗪	行 正 
𧗫	行 𠫤 
𧗱	行 米 
𧗲	行 山 王 
𧗳	行 言 
𧗴	行 甬 
𧗶	行 辛 
𧗸	行 戔 
𧗹	行 音 
𧗼	行 山 糸 
𧗿	行 率 
𧘂	行 童 
𧘃	行 買 
𧘈	衤 了 
𧘉	衣 冂 
𧘍	衤 工 
𧘏	衤 弓 
𧘐	衤 乇 
𧘑	衤 勺 
𧘓	衤 丈 
𧘗	口 衣 
𧘜	衤 千 
𧘝	衣 毛 
𧘞	衤 斗 
𧘟	衤 巿 
𧘢	衤 互 
𧘥	衤 丑 
𧘧	衤 𬺵 
𧘨	衣 弔 
𧘩	方 衣 
𧘫	衣 㞢 
𧘮	衣 凶 
𧘽	奴 衣 
𧘿	衤 正 
𧙀	衤 立 
𧙁	此 衣 
𧙃	衣 可 
𧙄	衤 本 
𧙅	衤 叵 
𧙆	衤 瓜 
𧙇	衤 宂 
𧙈	衤 司 
𧙉	衣 出 
𧙋	衤 只 
𧙌	衣 包 
𧙏	衣 由 
𧙛	衤 布 
𧙝	衤 斥 
𧙞	衤 朿 
𧙟	衤 曳 
𧙡	衤 亦 
𧙣	衤 夷 
𧙤	衤 朶 
𧙥	衤 同 
𧙧	衤 幵 
𧙭	弜 衣 
𧙮	衤 䒑 几 刂 
𧙶	宇 衣 
𧙸	衤 亙 
𧙺	衤 后 
𧙾	亻 攴 衣 
𧚀	衤 每 
𧚁	衤 完 
𧚂	衤 弄 
𧚃	衤 系 
𧚄	衤 我 
𧚅	衤 良 
𧚆	衤 孛 
𧚇	衤 免 
𧚉	衤 夋 
𧚋	衤 夆 
𧚏	衤 束 
𧚔	衤 甬 
𧚥	衤 取 
𧚨	衤 疌 
𧚩	𥝢 衣 
𧚪	衤 妾 
𧚫	衤 青 
𧚬	衤 空 
𧚭	衤 幷 
𧚯	衤 受 
𧚷	衤 𤽇 
𧛄	衤 𠆢 衣 
𧛏	衤 兹 
𧛒	衤 𰩬 
𧛓	衤 䖍 
𧛔	衤 毒 
𧛗	衤 突 
𧛚	衤 畏 
𧛞	衤 胡 
𧛟	衤 星 
𧛡	衤 咸 
𧛢	衤 致 
𧛧	口 袲 
𧛸	衤 芻 
𧛹	衤 翁 
𧛺	衤 屖 
𧛻	衤 索 
𧛼	衤 射 
𧛽	叞 衣 
𧛾	衤 盍 
𧜁	衤 殺 
𧜂	衤 師 
𧜃	衤 氣 
𧜅	衤 害 
𧜉	高 衣 
𧜊	衣 衣 日 
𧜔	衤 屑 
𧜕	衤 笑 
𧜚	氣 衣 
𧜞	衤 曼 
𧜠	衤 率 
𧜡	衤 盖 
𧜣	衤 鳥 
𧜤	殹 衣 
𧜦	衤 速 
𧜧	衤 舂 
𧜱	衤 娶 
𧜲	衤 谷 ⺝ 
𧜵	衤 帶 
𧜽	衤 旋 
𧝂	衤 賀 
𧝃	衤 矞 
𧝆	衤 朁 
𧝇	衤 費 
𧝉	衤 黹 
𧝊	衤 戠 
𧝋	衤 敦 
𧝎	衤 童 
𧝐	衤 啻 
𧝑	衣 㠭 
𧝒	衤 黃 
𧝔	衤 虛 
𧝕	衣 圍 
𧝗	敦 衣 
𧝘	衤 裒 
𧝜	衤 尞 
𧝤	衤 斯 
𧝪	衤 𡬵 
𧝫	衤 𭘧 
𧝬	敝 衣 
𧝮	衤 匊 心 
𧝲	衤 豦 
𧝳	衤 敫 
𧝵	衤 葉 
𧝷	毀 衣 
𧝸	衤 雍 
𧝹	𣎆 衣 
𧞀	衤 竪 
𧞍	衤 察 
𧞏	衤 與 
𧞐	斲 衣 
𧞒	士 冖 殳 禾 衣 
𧞓	衤 齊 
𧞔	衤 蓋 
𧞕	㼲 衣 
𧞝	衤 厂 𭘧 
𧞞	衤 熊 
𧞣	衤 厭 
𧞩	衤 𢧵 
𧞪	衤 巤 
𧞫	衤 豎 
𧞬	衤 韯 
𧞭	衤 畾 
𧞰	衤 慼 
𧞲	衤 𠁗 
𧞸	衤 遺 
𧞹	士 冖 殳 豕 衣 
𧞺	士 冖 殳 束 衣 
𧞻	衣 𤕦 
𧟃	衤 巂 
𧟄	衤 襄 
𧟌	衤 羅 
𧟑	衤 騫 
𧟘	衤 囊 
𧟙	衤 靈 
𧟜	衤 𰙉 
𧟠	襾 一 
𧟣	襾 几 
𧟨	襾 升 
𧟬	覀 丘 
𧟰	勿 要 
𧟱	襾 服 
𧟵	覀 服 
𧟼	襾 烓 
𧠂	襾 厂 言 攵 
𧠆	自 儿 
𧠈	又 見 
𧠋	見 廾 
𧠎	巿 見 
𧠒	壬 見 
𧠓	𠔿 見 
𧠚	分 見 
𧠛	止 見 
𧠜	台 見 
𧠝	㐱 見 
𧠞	戶 乙 見 
𧠟	氐 見 
𧠡	㐌 見 
𧠢	且 見 
𧠣	疋 見 
𧠥	𪩲 見 
𧠦	見 目 
𧠩	共 見 
𧠪	尗 見 
𧠫	至 見 
𧠬	㠩 見 
𧠴	見 寺 
𧠶	有 見 
𧠼	告 見 
𧠽	宎 見 
𧠾	孚 見 
𧡇	見 男 
𧡋	厓 見 
𧡍	東 見 
𧡎	兒 見 
𧡏	叕 見 
𧡑	𠧢 見 
𧡙	廿 火 見 
𧡚	直 見 
𧡜	明 見 
𧡡	軍 見 
𧡢	宣 見 
𧡣	秋 見 
𧡤	扁 見 
𧡦	𠂤 廾 見 
𧡨	是 見 
𧡩	爰 見 
𧡪	甚 見 
𧡫	癸 見 
𧡬	舟 彡 見 
𧡮	相 見 
𧡯	⺼ 䂓 
𧡴	柬 見 
𧡵	耷 見 
𧡶	星 見 
𧡸	𠁁 見 
𧡹	𠧴 見 
𧡺	耆 見 
𧡼	臣 火 見 
𧢂	殹 見 
𧢃	婁 見 
𧢄	票 見 
𧢆	舂 見 
𧢋	翏 見 
𧢌	臯 見 
𧢐	曾 見 
𧢒	微 見 
𧢖	艹 一 弥 見 
𧢛	𥃯 𥃯 𥃯 
𧢜	樊 見 
𧢞	肩 覞 
𧢢	龠 見 
𧢦	歸 見 
𧢧	巂 見 
𧢩	瞿 見 
𧢬	堯 覞 
𧢭	矍 見 
𧢵	角 丂 
𧢶	角 匕 
𧢹	角 巾 
𧢻	角 牛 
𧢼	爿 角 
𧢾	角 旡 
𧣁	角 冘 
𧣃	角 巴 
𧣈	角 牛 
𧣋	角 介 
𧣌	火 角 
𧣑	角 甘 
𧣒	角 巨 
𧣕	角 囚 
𧣖	角 它 
𧣛	角 四 
𧣟	角 㐌 
𧣡	多 角 
𧣢	角 艮 
𧣣	角 多 
𧣤	角 㫐 
𧣦	角 交 
𧣩	角 希 
𧣪	角 肖 
𧣬	角 冖 且 
𧣭	角 豸 
𧣵	角 侖 
𧣷	角 周 
𧣸	角 叕 
𧣹	角 炎 
𧣺	角 卓 
𧣻	角 居 
𧣼	角 或 
𧣾	角 虎 
𧤃	角 畀 
𧤍	角 帝 
𧤎	角 宣 
𧤏	角 咠 
𧤐	角 咼 
𧤑	𡘑 角 
𧤒	角 革 
𧤕	角 酋 
𧤖	角 畏 
𧤗	角 耑 
𧤙	秋 角 
𧤛	角 秦 
𧤜	角 鬲 
𧤟	角 氣 
𧤠	角 桀 
𧤡	角 致 
𧤣	角 草 
𧤨	角 晏 
𧤮	角 右 右 
𧤯	角 國 
𧤲	角 𤉄 
𧤴	殸 角 
𧤵	角 堅 
𧤼	角 厥 
𧤽	角 閒 
𧥄	角 戢 
𧥈	角 監 
𧥊	角 𥄳 欠 
𧥋	角 翟 
𧥌	角 廣 
𧥍	角 麃 
𧥎	角 𢿌 
𧥑	𢨋 角 
𧥓	角 毚 
𧥕	角 此 黽 
𧥖	角 麗 
𧥚	咸 咸 攴 角 
𧥛	亠 𠄠 冂 
𧥜	亠 𠄠 凵 
𧥞	言 丨 
𧥟	言 𠃌 
𧥣	言 口 
𧥤	言 尸 
𧥮	言 互 
𧥯	言 㸦 
𧥱	言 夫 
𧥴	言 卬 
𧥵	言 日 
𧥷	言 𠂉 一 乙 
𧥸	言 牛 
𧥹	言 丰 
𧥼	言 云 
𧥿	水 言 
𧦁	言 入 入 
𧦎	言 丿 口 
𧦑	言 亢 
𧦚	言 𢆰 
𧦝	言 乎 
𧦞	言 布 
𧦟	言 乏 
𧦤	言 加 
𧦧	言 㐌 
𧦭	言 他 
𧦴	癶 言 
𧦸	干 冂 言 
𧦹	言 本 
𧧁	夗 言 
𧧃	𦣞 言 
𧧄	言 妄 
𧧅	言 吏 
𧧆	言 𠂤 
𧧇	言 朶 
𧧉	言 广 乇 
𧧊	言 𠂋 巳 
𧧋	言 列 
𧧏	如 言 
𧧒	言 朿 
𧧓	言 血 
𧧔	言 舟 
𧧕	言 字 
𧧜	言 网 
𧧝	言 厊 
𧧟	言 𢦏 
𧧠	言 𢑑 
𧧩	言 亦 
𧧬	𢦏 言 
𧧭	言 夅 
𧧰	言 臣 
𧧵	言 㚒 
𧧶	言 余 
𧧸	言 別 
𧧹	亻 只 言 
𧧺	言 坒 
𧧻	言 作 
𧧾	言 貝 
𧨀	言 坐 
𧨂	言 何 
𧨄	言 芌 
𧨆	言 㐬 
𧨈	巫 言 
𧨊	言 厏 
𧨋	言 冂 正 
𧨗	言 㶣 
𧨡	言 君 
𧨢	言 ⺸ 
𧨧	⻖ 左 言 
𧨩	言 忝 
𧨰	言 制 
𧨱	言 底 
𧨲	尚 言 
𧨳	言 卓 
𧨴	言 事 
𧨵	言 厒 
𧨷	言 肯 
𧨸	言 典 
𧨹	言 彔 
𧨾	言 罙 
𧨿	言 工 白 
𧩅	言 广 七 夂 
𧩒	言 彡 母 
𧩓	言 忽 
𧩚	言 大 氺 
𧩝	言 龵 月 
𧩣	言 𡿺 
𧩦	言 亟 
𧩧	言 度 
𧩨	言 侯 
𧩪	言 怱 
𧩫	言 奓 
𧩬	言 頁 
𧩮	言 叜 
𧩰	言 穴 之 
𧩱	言 屏 
𧩲	言 剌 
𧩴	言 尼 木 
𧩶	言 契 
𧩸	言 弇 
𧩹	言 施 
𧩼	言 致 
𧪅	言 怒 
𧪇	言 耷 
𧪓	言 禺 
𧪕	言 叚 
𧪘	言 差 
𧪚	言 豈 
𧪝	言 乘 
𧪞	言 盍 
𧪠	言 疾 
𧪡	言 耆 
𧪢	言 氣 
𧪣	言 烝 
𧪨	言 馬 
𧪫	言 𣬉 
𧪮	言 荂 
𧪯	言 𠳋 
𧪷	𠀠 言 斤 
𧪹	言 宰 
𧫊	彧 言 
𧫑	言 笈 
𧫒	言 𡨧 
𧫓	言 鹵 
𧫕	言 祭 
𧫗	言 爽 
𧫛	言 羕 
𧫜	既 言 
𧫝	言 𡕩 
𧫞	言 屚 
𧫠	言 基 
𧫡	言 窒 
𧫢	言 望 
𧫤	言 畢 
𧫥	言 庵 
𧫦	殹 言 
𧫧	言 酓 
𧫹	詹 令 
𧫾	言 就 
𧫿	言 尋 
𧬁	言 臯 
𧬂	言 賀 
𧬅	言 屠 
𧬆	言 善 
𧬇	言 壹 
𧬈	言 翕 
𧬊	斯 言 
𧬋	言 發 
𧬌	言 喦 
𧬏	言 莽 
𧬕	言 辜 
𧬞	言 雲 
𧬤	言 童 
𧬦	諍 爭 
𧬧	言 葵 
𧬨	言 歲 
𧬩	言 䪞 
𧬫	言 煎 
𧬬	言 業 
𧬮	言 𥈀 
𧬰	鄉 言 
𧬱	言 閜 
𧬻	言 達 
𧭃	㚘 詹 
𧭇	言 白 穴 方 
𧭈	言 寧 
𧭊	言 蒙 
𧭌	言 㼲 
𧭍	言 聚 
𧭎	言 僕 
𧭏	言 臺 
𧭓	言 熒 
𧭔	舟 羽 𠆢 言 
𧭚	言 説 
𧭜	言 慮 
𧭝	言 蔡 
𧭞	言 巤 
𧭟	言 遲 
𧭠	言 寫 
𧭤	言 暴 
𧭥	言 樂 
𧭦	言 敻 
𧭪	言 𠍳 
𧭭	𨿳 言 
𧭳	𠾳 言 
𧭵	言 魅 
𧭸	言 韰 
𧭹	頻 言 
𧭻	諴 言 
𧭼	言 親 
𧭽	言 艹 訾 
𧭾	言 䝿 
𧮆	言 嬰 
𧮇	言 邁 
𧮈	言 蹇 
𧮍	言 闇 
𧮑	言 闒 
𧮒	言 醫 
𧮓	言 魋 
𧮗	譶 心 
𧮙	𣫞 言 
𧮚	言 蠆 
𧮛	言 離 
𧮝	瀕 言 
𧮞	言 矍 
𧮠	言 黁 
𧮡	言 竇 
𧮤	言 覽 
𧮫	𠆢 𠆢 口 
𧮬	谷 卂 
𧮭	谷 丸 
𧮮	谷 千 
𧮯	厷 谷 
𧮰	谷 今 
𧮱	谷 分 
𧮳	谷 甘 
𧮴	谷 古 
𧮵	谷 合 
𧮶	谷 后 
𧮺	谷 戔 
𧮻	谷 周 
𧮼	㐫 冂 谷 
𧮽	谷 虎 
𧮿	谷 舍 
𧯀	谷 英 
𧯃	谷 咸 
𧯆	谷 害 
𧯈	谷 𡭴 
𧯉	容 谷 
𧯊	谷 𡭽 
𧯋	谷 閕 
𧯌	谷 臯 
𧯍	谷 勞 
𧯏	厤 谷 
𧯒	谷 曾 
𧯖	谷 𥈠 
𧯗	谷 雨 奚 
𧯘	谷 闞 
𧯞	豆 斤 
𧯠	豆 句 
𧯡	夗 豆 
𧯤	豆 乍 
𧯥	𢦏 豆 
𧯦	龹 豆 
𧯨	豆 多 
𧯩	豆 足 
𧯫	登 丁 
𧯯	豆 其 
𧯰	豆 臽 
𧯱	豆 或 
𧯲	豆 來 
𧯷	艹 氶 豆 
𧯺	交 豈 
𧯼	壴 周 
𧯾	壴 東 
𧰂	豆 𦐇 
𧰃	豆 婁 
𧰄	享 豈 
𧰇	壴 臾 
𧰈	務 豆 
𧰊	壴 真 
𧰒	壴 國 
𧰙	豈 幾 
𧰠	壴 巤 
𧰣	壴 薰 
𧰩	豕 丁 
𧰪	干 豕 
𧰫	豕 久 
𧰯	豕 厷 
𧰰	豕 尤 
𧰱	豕 刀 又 
𧰲	彑 豕 
𧰴	豕 勾 
𧰵	豖 殳 
𧰷	豕 母 
𧰸	豕 皮 
𧰹	豕 出 
𧰻	豕 令 
𧰿	豕 艾 
𧱀	豕 先 
𧱄	吅 豕 
𧱅	豕 夷 
𧱆	豕 𠕋 
𧱏	辛 豕 
𧱐	豕 孝 
𧱒	豕 巵 
𧱓	豕 尨 
𧱘	豙 介 
𧱜	豕 侖 
𧱝	叕 豕 
𧱡	豕 空 
𧱢	豕 尸 令 
𧱩	豕 便 
𧱪	豕 奏 
𧱬	豕 俞 
𧱰	豕 矛 攴 
𧱲	豕 氣 
𧱳	豙 ⾆ 
𧱴	豕 冥 
𧱵	豕 唐 
𧱹	豕 尃 
𧱻	豕 覓 
𧱼	豕 㒼 
𧱾	豩 犬 
𧲀	豕 牽 
𧲂	豕 粦 
𧲃	豕 閔 
𧲄	豕 爲 
𧲅	豕 曾 
𧲇	嗀 豕 
𧲈	豕 遀 
𧲋	豕 豦 
𧲌	豕 箑 
𧲍	豕 夢 
𧲕	豕 母 婁 
𧲘	豕 戲 
𧲙	豕 霝 
𧲜	辟 象 
𧲝	䘙 豚 
𧲡	豸 力 
𧲢	豸 乇 
𧲤	豸 牛 
𧲥	豸 日 
𧲦	豸 元 
𧲧	豸 巴 
𧲨	豸 开 
𧲭	豸 左 
𧲮	豸 乍 
𧲯	豸 犮 
𧲰	豸 丘 
𧲱	豸 央 
𧲴	豸 冬 
𧲵	豸 圣 
𧲺	豸 平 
𧲻	豸 只 
𧲾	豸 𠕋 
𧲿	豸 后 
𧳀	豸 𭗼 
𧳁	豸 多 
𧳂	豸 伏 
𧳄	豸 囟 
𧳅	豸 吏 
𧳆	豸 同 
𧳉	豸 并 
𧳌	豸 禿 
𧳍	豸 肖 
𧳎	豸 吾 
𧳏	豸 否 
𧳐	豸 希 
𧳒	豸 貝 
𧳕	豸 来 
𧳙	豸 隶 
𧳚	豸 卒 
𧳛	豸 妾 
𧳜	豸 周 
𧳝	豸 卓 
𧳞	豸 隹 
𧳟	豸 來 
𧳠	豸 畀 
𧳣	豸 東 
𧳦	豸 𡿺 
𧳧	豸 皆 
𧳨	豸 柔 
𧳩	豸 彖 
𧳪	豸 胃 
𧳫	豸 酋 
𧳬	豸 眉 
𧳭	豸 爰 
𧳮	豸 重 
𧳶	豸 叟 
𧳸	豸 骨 
𧳹	豸 芻 
𧳺	豸 𰙩 
𧳻	豸 爪 虫 
𧳼	豸 口 弟 
𧳿	豸 重 ⺃ 
𧴁	豸 离 
𧴂	豸 逢 
𧴃	豸 斬 
𧴄	豸 庸 
𧴅	豸 爽 
𧴉	豸 晜 
𧴊	豸 患 
𧴎	豸 歮 
𧴓	豸 𦓔 
𧴕	豸 惢 
𧴖	豸 歲 
𧴗	豸 雍 
𧴙	豸 歰 
𧴚	豸 會 
𧴠	豸 歷 
𧴢	豸 䀠 冖 且 
𧴣	豸 嚴 
𧴤	貝 卜 
𧴥	力 貝 
𧴪	小 貝 
𧴬	貝 刃 
𧴭	彡 貝 
𧴲	巛 貝 
𧴸	貝 冘 
𧴺	丿 幺 貝 
𧵃	貝 手 
𧵈	貝 勾 
𧵊	貝 甘 
𧵋	貝 示 
𧵌	貝 央 
𧵎	古 貝 
𧵑	貝 古 
𧵛	貝 可 
𧵞	口 九 貝 
𧵠	出 貝 
𧵡	貝 册 
𧵢	貝 包 
𧵣	貝 旬 
𧵤	貝 守 
𧵧	貝 𠫤 
𧵨	貝 安 
𧵬	貝 𠂢 
𧵭	幵 貝 
𧵱	厽 貝 
𧵳	貝 干 口 
𧵴	貝 宇 
𧵻	貝 式 
𧵼	至 貝 
𧶄	貝 争 
𧶆	貝 吝 
𧶇	貝 折 
𧶊	員 云 
𧶍	貝 𢦙 
𧶔	貝 呈 
𧶕	貝 我 
𧶖	貝 希 
𧶙	北 負 
𧶠	士 四 貝 
𧶡	宓 貝 
𧶲	貝 耑 
𧶵	貝 臿 
𧶶	買 反 
𧶷	正 責 
𧶸	貝 貞 
𧶺	貝 亭 
𧷅	𠕀 貴 
𧷋	要 貝 
𧷎	㕢 土 
𧷐	分 賁 
𧷑	蚔 貝 
𧷒	貝 真 
𧷛	貝 鬼 
𧷟	分 賓 
𧷡	貝 婁 
𧷥	䟝 貝 
𧷦	貝 密 
𧷱	貢 𱣀 
𧷳	貝 累 
𧷴	𠊰 貝 
𧷶	貝 𦍌 古 
𧷾	貝 矞 
𧷿	貝 都 
𧸂	貝 敢 
𧸅	貝 业 㡀 
𧸈	必 賓 
𧸖	貝 廉 
𧸗	貝 歲 
𧸘	貝 僉 
𧸙	貝 遂 
𧸦	貝 監 
𧸧	與 貝 
𧸨	貝 白 穴 方 
𧸪	貝 𠪨 
𧸫	員 袞 
𧸮	貝 微 
𧸲	貝 質 
𧸽	貝 遺 
𧸾	虎 武 貝 
𧸿	貝 寫 
𧹈	贔 大 
𧹊	貝 龠 
𧹌	壹 資 
𧹐	貝 羅 
𧹑	贝 为 
𧹓	贝 呈 
𧹕	贝 居 
𧹛	赤 支 
𧹞	赤 皮 
𧹣	赤 含 
𧹨	昔 赤 
𧹩	赤 東 
𧹬	赤 垔 
𧹭	赤 畐 
𧹲	𣪊 赤 
𧹳	𠦝 入 赤 
𧹴	赤 畜 
𧹶	赤 累 
𧹺	赤 毳 
𧹽	赤 㬎 
𧹾	疑 赤 
𧺅	書 覀 赤 
𧺆	夭 龰 
𧺍	走 八 
𧺎	走 九 
𧺏	走 也 
𧺐	走 了 一 
𧺒	走 下 
𧺜	走 女 
𧺝	走 日 
𧺟	走 冘 
𧺠	走 止 
𧺡	走 巿 
𧺢	走 殳 
𧺣	走 从 
𧺤	走 勼 
𧺧	走 廿 
𧺨	走 心 
𧺫	走 尺 
𧺰	走 歹 
𧺲	走 比 
𧺴	走 午 
𧺶	走 术 
𧺷	走 去 
𧺸	走 冋 
𧺹	走 巨 
𧺺	走 犮 
𧺼	走 此 
𧺽	走 㠯 
𧺾	走 半 
𧺿	走 世 
𧻁	走 丘 
𧻃	走 目 
𧻍	走 只 
𧻒	走 劦 
𧻓	走 并 
𧻔	走 匡 
𧻕	走 朿 
𧻖	走 舟 
𧻗	走 戌 
𧻘	走 㓞 
𧻙	走 百 
𧻚	走 亘 
𧻜	走 危 
𧻝	走 𠂉 支 
𧻧	走 𢇛 
𧻰	走 告 
𧻱	走 求 
𧻲	走 里 
𧻳	走 否 
𧻴	走 良 
𧻵	走 夾 
𧻶	走 希 
𧻷	走 甫 
𧻸	走 折 
𧻹	走 甬 
𧻺	走 狂 
𧻼	走 圼 
𧻿	走 豆 
𧼊	走 見 
𧼎	走 奄 
𧼏	走 弦 
𧼐	走 囷 
𧼑	走 或 
𧼒	走 臤 
𧼓	走 東 
𧼔	走 夌 
𧼕	走 刺 
𧼖	林 走 
𧼗	走 岪 
𧼘	走 奇 
𧼙	走 豖 
𧼜	走 尸 八 夕 
𧼟	走 陌 
𧼠	走 卑 
𧼤	走 到 
𧼨	走 曷 
𧼩	走 重 
𧼪	走 契 
𧼫	走 胃 
𧼭	走 叜 
𧼯	走 俞 
𧼰	走 臿 
𧼱	走 复 
𧼳	走 广 屰 
𧼴	走 耑 
𧼵	走 矦 
𧼶	走 𠚏 
𧽅	走 枼 
𧽆	走 厘 
𧽉	走 晏 
𧽊	走 豈 
𧽋	走 烏 
𧽌	走 骨 
𧽍	走 真 
𧽎	走 䍃 
𧽏	走 叟 
𧽐	走 虔 
𧽑	走 疾 
𧽒	走 臭 
𧽓	走 欯 
𧽔	走 宀 石 又 
𧽖	走 留 
𧽞	走 焉 
𧽟	走 雀 
𧽠	走 崔 
𧽢	走 專 
𧽣	走 章 
𧽤	走 票 
𧽥	走 鹿 
𧽦	走 啇 
𧽧	走 崇 
𧽨	走 覓 
𧽩	將 走 
𧽯	走 斬 
𧽲	走 累 
𧽶	走 爲 
𧽷	走 肅 
𧽸	走 厥 
𧽻	走 矞 
𧽼	走 覃 
𧽽	走 尞 
𧽾	走 散 
𧽿	走 童 
𧾁	走 䨿 
𧾂	走 戟 
𧾆	走 萌 
𧾇	走 覀 大 丶 龴 
𧾊	走 登 
𧾍	走 亶 
𧾎	走 睘 
𧾏	走 僉 
𧾐	走 敫 
𧾑	走 辟 
𧾔	走 咸 心 
𧾚	走 與 
𧾝	走 㕡 
𧾠	走 穴 余 又 
𧾡	走 廛 
𧾢	走 𢧵 
𧾣	走 敻 
𧾤	走 憂 
𧾥	走 賣 
𧾧	走 慮 
𧾨	走 憲 
𧾩	走 叡 
𧾫	走 自 穴 冋 
𧾮	走 霝 
𧾯	走 薊 
𧾰	走 翼 
𧾱	走 瞿 
𧾲	走 藍 
𧾳	走 豐 
𧾵	走 矍 
𧾶	走 䖝 䖝 䖝 
𧾻	𧾷 丩 
𧾽	𧾷 十 
𧾾	𧾷 几 
𧿅	𧾷 卂 
𧿆	𧾷 已 
𧿈	𧾷 广 
𧿉	𧾷 亐 
𧿋	𧾷 一 丩 
𧿌	𧾷 乇 
𧿏	𧾷 𭅲 
𧿒	𧾷 冘 
𧿓	𧾷 㸦 
𧿔	𧾷 丑 
𧿖	𧾷 凶 
𧿘	𧾷 升 
𧿙	𧾷 元 
𧿚	𧾷 分 
𧿝	𧾷 兮 
𧿞	𧾷 欠 
𧿠	𧾷 𢆰 
𧿥	𧾷 比 
𧿧	𧾷 斤 
𧿨	𧾷 反 
𧿩	𧾷 介 
𧿫	𧾷 斗 
𧿲	𧾷 𠂔 
𧿳	𧾷 弗 
𧿴	𧾷 末 
𧿵	𧾷 甲 
𧿶	𧾷 㐌 
𧿷	𧾷 玉 
𧿺	𧾷 出 
𧿻	𧾷 尻 
𧿼	𧾷 瓜 
𧿽	𧾷 叵 
𨀀	𧾷 尒 
𨀄	𧾷 瓦 
𨀅	𧾷 冉 
𨀕	𧾷 匡 
𨀖	𧾷 亥 
𨀘	𧾷 羊 
𨀙	𧾷 吉 
𨀛	𧾷 存 
𨀜	𧾷 同 
𨀝	𧾷 叒 
𨀟	𧾷 㡯 
𨀠	𧾷 𢇛 
𨀤	𧾷 耒 
𨀥	𧾷 次 
𨀧	𧾷 丞 
𨀨	𧾷 𡿪 
𨀫	𧾷 𠂉 亢 
𨀬	𧾷 在 
𨀮	𧾷 䏍 
𨀯	𧾷 邛 
𨀳	𧾷 伐 
𨀴	𧾷 旬 
𨀵	𧾷 庄 
𨀶	亦 足 
𨀸	𧾷 宅 
𨁀	攸 足 
𨁁	𧾷 𭻾 
𨁂	𧾷 夾 
𨁃	𧾷 弟 
𨁄	𧾷 旱 
𨁅	𧾷 辛 
𨁆	𧾷 延 
𨁇	𧾷 吞 
𨁈	𧾷 更 
𨁉	𧾷 困 
𨁊	𧾷 岑 
𨁋	𧾷 豆 
𨁌	𧾷 那 
𨁍	𧾷 見 
𨁎	𧾷 呈 
𨁏	𧾷 甫 
𨁐	𧾷 弃 
𨁑	𧾷 兌 
𨁒	𧾷 告 
𨁗	𧾷 廴 壬 
𨁟	𧾷 我 
𨁠	𧾷 𡉼 
𨁡	𧾷 妥 
𨁴	𧾷 间 
𨁶	𧾷 亞 
𨁷	𧾷 直 
𨁸	𧾷 戾 
𨁹	𧾷 炎 
𨁺	𧾷 具 
𨁽	𧾷 㝵 
𨁿	𧾷 豖 
𨂀	𧾷 阻 
𨂁	𧾷 奄 
𨂂	𧾷 炙 
𨂃	𧾷 朋 
𨂅	𧾷 㡀 
𨂇	𧾷 戶 止 
𨂊	𧾷 周 
𨂋	𧾷 斉 
𨂐	𧾷 來 
𨂒	𧾷 夜 
𨂜	𧾷 虎 
𨂝	並 足 
𨂞	足 並 
𨂟	𧾷 𠂉 𡈼 儿 
𨂠	𧾷 頁 
𨂡	𧾷 奏 
𨂢	即 足 
𨂣	敄 足 
𨂦	𧾷 彖 
𨂩	𧾷 癹 
𨂪	𧾷 彥 
𨂫	𧾷 㡿 
𨂭	𧾷 毒 
𨂯	𧾷 便 
𨂰	𧾷 契 
𨂱	𧾷 軍 
𨂲	𧾷 屏 
𨂴	𧾷 怱 
𨂵	𧾷 臿 
𨂺	𧾷 弯 
𨂽	𧾷 石 水 
𨂿	𧾷 歪 
𨃃	𧾷 曷 
𨃄	𧾷 畏 
𨃅	𧾷 拜 
𨃇	𧾷 姜 
𨃉	𧾷 待 
𨃓	𧾷 茶 
𨃕	𧾷 畜 
𨃖	𧾷 荂 
𨃗	朕 足 
𨃘	𧾷 芻 
𨃙	𧾷 栗 
𨃚	𧾷 荅 
𨃛	𧾷 ⻖ 辛 
𨃞	般 足 
𨃟	𧾷 般 
𨃣	𧾷 蚤 
𨃤	𧾷 高 
𨃭	𧾷 栽 
𨃯	𧾷 時 
𨃰	𧾷 兼 
𨃲	書 足 
𨃳	𧾷 能 
𨄄	𧾷 恋 
𨄅	𧾷 區 
𨄇	𧾷 龹 氺 
𨄈	𧾷 梁 
𨄉	𧾷 產 
𨄊	𧾷 祭 
𨄋	𧾷 屚 
𨄌	𧾷 習 
𨄍	𧾷 崔 
𨄐	𧾷 紫 
𨄓	𧾷 巢 
𨄔	𧾷 專 
𨄕	𧾷 族 
𨄗	𧾷 康 
𨄚	將 足 
𨄮	𧾷 率 
𨄯	尉 足 
𨄰	𧾷 張 
𨄱	𧾷 累 
𨅅	𧾷 止 技 
𨅊	𧾷 𰕎 
𨅋	𧾷 肅 
𨅍	𧾷 間 
𨅎	𧾷 最 
𨅏	𧾷 嵐 
𨅑	𧾷 須 
𨅒	𧾷 尌 
𨅓	𧾷 奢 
𨅔	𧾷 朁 
𨅗	𧾷 筆 
𨅘	彭 足 
𨅣	𧾷 㙓 
𨅤	𧾷 朞 
𨅪	牙 牙 足 牙 
𨅬	𧾷 阑 
𨅭	𧾷 覃 
𨆁	𧾷 亶 
𨆂	𧾷 䪞 
𨆃	𧾷 禁 
𨆄	𧾷 楚 
𨆅	𧾷 睪 
𨆇	𧾷 閘 
𨆈	𧾷 睘 
𨆉	𧾷 當 
𨆊	鼓 足 
𨆋	𧾷 義 
𨆌	𧾷 煩 
𨆍	𧾷 葛 
𨆎	𧾷 賊 
𨆏	𧾷 遂 
𨆓	𧾷 禽 
𨆙	𧾷 瑟 
𨆧	輊 足 
𨆨	𧾷 𠃊 貴 
𨆰	𧾷 㬎 
𨆱	𧾷 凴 
𨆲	𧾷 㥯 
𨆵	𧾷 頗 
𨆽	𧾷 麽 
𨆾	𧾷 察 
𨇁	𧾷 廣 
𨇃	𧾷 賛 
𨇄	𧾷 憂 
𨇅	𧾷 暴 
𨇆	𧾷 厲 
𨇍	𧾷 輦 
𨇎	𨂷 全 
𨇕	𧾷 彳 吞 𠕁 
𨇖	𧾷 盧 
𨇗	𧾷 歷 
𨇘	龍 足 
𨇙	𧾷 衞 
𨇝	𧾷 閻 
𨇤	𧾷 鮮 
𨇦	𧾷 韱 
𨇨	𧾷 薛 
𨇩	𧾷 毚 
𨇯	𧾷 雙 
𨇻	𧾷 靡 
𨇼	𧾷 䜌 
𨇽	𧾷 羅 
𨈀	𧾷 顛 
𨈆	𧾷 蘭 
𨈇	𧾷 覽 
𨈈	𧾷 疊 
𨈊	𧾷 彎 
𨈋	𧾷 籥 
𨈌	𧾷 戀 
𨈎	𧾷 鸞 
𨈕	身 ⻏ 
𨈖	身 口 
𨈗	口 身 
𨈘	身 少 
𨈙	身 攴 
𨈚	身 比 
𨈥	身 毛 
𨈧	身 引 
𨈩	身 犮 
𨈫	身 主 
𨈮	身 申 
𨈶	身 母 
𨈷	身 它 
𨈹	身 同 
𨈺	身 老 
𨉁	身 光 
𨉃	任 身 
𨉅	身 亼 丌 
𨉋	身 兌 
𨉖	門 身 
𨉗	身 宝 
𨉚	身 奄 
𨉜	身 周 
𨉝	身 宛 
𨉡	身 垂 
𨉢	身 重 
𨉣	身 叚 
𨉤	身 皇 
𨉥	身 面 
𨉩	身 春 
𨉪	身 曷 
𨉫	身 勹 吕 
𨉬	身 亭 
𨉭	身 眉 
𨉱	身 弱 
𨉴	身 茸 
𨉷	身 容 
𨉸	身 馬 
𨉹	身 國 
𨉽	身 囯 王 
𨉾	身 𥬥 
𨊅	身 堯 
𨊈	身 覃 
𨊉	身 毳 
𨊔	身 監 
𨊘	軀 心 
𨊚	身 磊 
𨊛	身 歷 
𨊝	身 蹔 
𨊞	身 聶 
𨊟	䜌 身 
𨊡	車 丁 
𨊧	車 工 
𨊰	車 乞 
𨊱	車 于 
𨊳	車 心 
𨊸	車 月 
𨊹	車 巴 
𨊺	車 止 
𨊻	車 开 
𨊼	車 尹 
𨊿	車 㕛 
𨋀	車 丑 
𨋈	車 水 
𨋉	水 車 
𨋐	車 瓦 
𨋑	工 几 車 
𨋒	車 弁 
𨋔	車 玉 
𨋕	車 卬 
𨋖	車 卯 
𨋗	車 尼 
𨋘	車 乍 
𨋙	車 申 
𨋚	車 㞋 
𨋛	車 𡯄 
𨋝	車 功 
𨋞	車 布 
𨋟	禾 車 
𨋠	車 宂 
𨋡	出 車 
𨋥	車 弗 
𨋦	車 𠬦 
𨋧	白 車 
𨋨	車 艮 
𨋩	車 伏 
𨋫	車 兆 
𨋬	丞 車 
𨋮	車 旬 
𨋯	車 曳 
𨋰	車 次 
𨋲	車 冰 
𨋷	車 工 工 
𨋺	臼 車 
𨋽	車 羊 
𨋾	車 羽 
𨌁	車 旨 
𨌄	壯 車 
𨌆	車 宏 
𨌈	車 身 
𨌌	車 巵 
𨌍	車 辛 
𨌎	車 余 
𨌑	車 辰 
𨌔	車 兌 
𨌘	車 夋 
𨌝	車 𠆢 升 丶 
𨌠	車 彔 
𨌢	車 爭 
𨌣	車 芮 
𨌤	亠 舛 車 
𨌥	玨 車 
𨌧	車 奄 
𨌨	車 匋 
𨌩	車 尚 
𨌫	車 卷 
𨌬	車 卓 
𨌭	車 沓 
𨌮	車 底 
𨌲	車 昏 
𨌳	車 肯 
𨌴	車 隹 
𨌶	車 盲 
𨍅	車 𦬣 
𨍆	車 昌 
𨍇	車 客 
𨍈	車 㚇 
𨍉	車 怱 
𨍊	車 秋 
𨍎	敄 車 
𨍏	車 度 
𨍐	車 胥 
𨍑	車 音 
𨍛	車 毒 
𨍜	車 甚 
𨍞	車 英 
𨍢	車 咨 
𨍧	車 皇 
𨍩	車 旁 
𨍫	車 栗 
𨍭	車 尃 
𨍮	車 鬲 
𨍯	日 輂 
𨍰	車 盍 
𨍲	車 圂 
𨍳	車 䍃 
𨍴	車 唐 
𨍶	𤇾 車 
𨍷	車 茸 
𨍸	車 留 
𨍹	車 鬼 
𨍺	車 尸 丬 支 
𨍽	車 衮 
𨎉	車 𠂆 疌 
𨎋	車 堂 
𨎌	執 車 
𨎍	車 康 
𨎔	車 𦰩 
𨎖	堂 車 
𨎗	車 𢒗 
𨎛	車 梁 
𨎝	車 曹 
𨎡	車 亠 尸 伐 
𨎢	車 恿 
𨎤	車 登 
𨎦	車 臯 
𨎧	車 彭 
𨎩	車 黃 
𨎪	車 𦓔 
𨎫	車 閒 
𨎬	車 堯 
𨎭	車 袲 
𨎮	車 菆 
𨎳	車 𥭗 
𨎴	車 當 
𨎶	車 豦 
𨎷	車 廉 
𨎸	車 楘 
𨎹	車 稟 
𨎾	車 𰀉 一 貝 
𨏂	車 運 
𨏆	䡛 光 
𨏈	車 㥯 
𨏉	𮅕 車 
𨏒	車 磊 
𨏔	車 賣 
𨏚	車 合 革 
𨏛	車 𮖠 
𨏞	頻 車 
𨏠	車 龍 
𨏤	車 𠆢 爾 
𨏥	車 憲 
𨏨	車 雨 並 
𨏩	𣎆 連 
𨏪	車 韱 
𨏫	車 薄 
𨏬	䡛 鬲 
𨏳	車 巂 
𨏴	車 聶 
𨏵	車 爫 尸 止 几 巳 夂 
𨏶	䜌 車 
𨏹	車 矍 
𨏺	𨏖 舟 
𨐁	車 疊 
𨐃	鑫 車 
𨐅	车 殳 
𨐆	车 开 
𨐇	车 龙 
𨐉	车 菆 
𨐊	车 憲 
𨐋	亠 𢆉 
𨐍	彡 辛 
𨐑	辛 允 
𨐔	多 辛 
𨐕	𢑑 辛 
𨐖	杀 辛 
𨐛	尿 辛 
𨐡	辛 苦 
𨐣	辛 𭩢 
𨐥	辛 革 
𨐦	辛 風 
𨐨	辟 井 
𨐩	辛 兼 
𨐰	辛 分 辛 
𨐱	辛 月 辛 
𨐴	辟 甲 
𨐶	辛 畫 
𨐾	⺄ 辯 
𨑊	多 農 
𨑌	畾 辰 
𨑎	辶 𰛄 
𨑹	辶 从 
𨑼	辶 𢆰 
𨑽	辶 丮 
𨑿	辶 凵 十 
𨒀	辶 𠚪 
𨒃	辶 半 
𨒄	辶 㕣 
𨒅	辶 只 
𨒆	辶 宂 
𨒇	辶 甲 
𨒈	辶 𡰥 
𨒉	辶 𠂔 
𨒊	辶 囚 
𨒋	辶 戉 
𨒌	辶 正 
𨒍	辶 卉 
𨒑	辶 巨 
𨒙	辶 石 
𨒜	辶 必 
𨒞	辶 出 
𨒤	辶 此 
𨒦	辶 印 
𨒧	辶 曳 
𨒨	辶 亥 
𨒩	辶 而 
𨒫	辶 羊 
𨒬	辶 至 
𨒮	辶 次 
𨒱	辶 共 
𨒲	辶 朱 
𨒴	辶 厽 
𨒼	辵 艮 
𨒽	辶 艸 
𨓁	辶 𢆶 
𨓇	辶 希 
𨓈	辶 𠯑 
𨓊	辶 𦔮 
𨓍	辶 𭙕 
𨓚	辶 兑 
𨓞	辶 㐬 
𨓠	辶 尸 巿 
𨓦	辶 里 
𨓨	辶 角 
𨓩	辶 广 火 
𨓬	辶 沓 
𨓭	辶 取 
𨓮	辶 㸒 
𨓯	辶 𣶒 
𨓰	辶 疌 
𨓲	辶 侃 
𨓳	辶 杳 
𨓴	辶 卸 
𨓷	辶 𡿱 
𨓿	辶 非 
𨔗	辶 咖 
𨔙	辶 大 石 
𨔛	辶 虎 
𨔡	辶 彐 𧰨 
𨔢	辶 𧈪 
𨔣	辶 枷 
𨔤	辶 𠡠 
𨔥	辶 𦘔 
𨔦	辶 壴 
𨔯	辶 日 氺 
𨔵	辶 彖 
𨕕	辶 𠫓 㠯 
𨕗	辶 飛 
𨕚	辶 囗 八 日 
𨕜	迷 乆 
𨕠	辶 窄 
𨕢	辶 畜 
𨕦	辶 宀 八 𠆢 夂 
𨕧	辶 𢆶 开 
𨕹	辶 桓 
𨕺	辶 大 言 
𨕻	辶 日 艮 
𨕽	辵 入 疌 
𨕿	辶 弓 土 王 
𨖃	辶 笏 
𨖊	辶 責 
𨖋	辶 寁 
𨖌	辶 羕 
𨖎	辶 笞 
𨖛	辶 𩁹 
𨖠	辶 𠂆 扁 
𨖢	辶 犭 玨 
𨖬	辶 笙 
𨖭	辶 崖 
𨖰	造 六 
𨖱	辶 牽 
𨖳	辶 淵 
𨖴	辶 無 
𨖵	辶 焦 
𨖶	辶 象 
𨖷	辶 筆 
𨖹	辶 𬛳 
𨖼	辶 丿 ⺫ 乑 
𨖾	辶 絲 
𨖿	辶 爲 
𨗓	辶 口 首 
𨗝	辵 矞 
𨗞	辶 屾 回 
𨗡	辶 竹 吉 
𨗥	辶 會 
𨗦	辶 僉 
𨗨	辶 葦 
𨗰	辶 卣 糸 
𨗼	辶 𠂉 帶 
𨗾	辶 父 𦍒 
𨘁	辶 幺 方 糸 
𨘂	辶 君 多 
𨘃	辶 痯 
𨘇	辶 舝 
𨘉	辶 箑 
𨘌	辶 禍 
𨘔	辶 誩 
𨘕	辶 與 
𨘙	辶 玄 軍 
𨘬	辶 蔕 
𨘮	辶 𧆞 多 
𨘲	辶 竹 室 
𨘴	辶 靠 
𨘵	辶 㔽 見 
𨘷	辶 䫉 
𨘸	辶 歷 
𨘼	辶 輲 
𨘾	辶 霍 
𨙀	辶 土 革 殳 
𨙂	辶 繇 
𨙄	辶 龠 
𨙎	辶 𧪟 
𨙏	辶 艸 章 
𨙓	辶 聶 
𨙔	辶 𩣷 
𨙡	辶 𡸁 鳥 
𨙩	十 ⻏ 
𨙫	口 ⻏ 
𨙬	己 ⻏ 
𨙭	土 ⻏ 
𨙮	凡 ⻏ 
𨙯	寸 ⻏ 
𨙳	叉 ⻏ 
𨙴	才 ⻏ 
𨙵	乡 ⻏ 
𨙶	巿 ⻏ 
𨙷	井 ⻏ 
𨙹	少 ⻏ 
𨙺	丑 ⻏ 
𨙻	冄 ⻏ 
𨙽	今 ⻏ 
𨚍	比 ⻏ 
𨚓	弗 ⻏ 
𨚔	包 ⻏ 
𨚖	此 ⻏ 
𨚗	冉 ⻏ 
𨚘	未 ⻏ 
𨚙	号 ⻏ 
𨚡	氶 邑 
𨚣	正 ⻏ 
𨚧	加 ⻏ 
𨚮	白 ⻏ 
𨚯	同 ⻏ 
𨚰	早 ⻏ 
𨚱	丞 ⻏ 
𨚲	存 ⻏ 
𨚳	亡 巛 ⻏ 
𨚴	如 ⻏ 
𨚵	𢦏 邑 
𨚶	年 ⻏ 
𨚾	𡕒 𡕒 ⻏ 
𨛈	全 ⻏ 
𨛉	色 ⻏ 
𨛊	犭 大 ⻏ 
𨛋	里 ⻏ 
𨛍	肖 ⻏ 
𨛎	旱 ⻏ 
𨛏	坐 ⻏ 
𨛑	忌 ⻏ 
𨛒	步 ⻏ 
𨛓	弄 ⻏ 
𨛔	否 ⻏ 
𨛕	卣 ⻏ 
𨛖	⺊ 𠕁 ⻏ 
𨛡	肙 ⻏ 
𨛣	含 ⻏ 
𨛤	豕 ⻏ 
𨛥	角 ⻏ 
𨛫	𥝢 邑 
𨛬	非 邑 
𨛭	舍 ⻏ 
𨛮	居 ⻏ 
𨛯	宜 ⻏ 
𨛰	爭 ⻏ 
𨛱	宗 ⻏ 
𨛲	禾 千 ⻏ 
𨛳	昔 ⻏ 
𨛵	虎 ⻏ 
𨛶	受 ⻏ 
𨜂	尚 邑 
𨜌	官 ⻏ 
𨜍	杲 ⻏ 
𨜎	𣏋 ⻏ 
𨜏	盈 ⻏ 
𨜐	思 ⻏ 
𨜑	目 木 ⻏ 
𨜒	契 ⻏ 
𨜓	貞 ⻏ 
𨜔	皇 ⻏ 
𨜖	禺 ⻏ 
𨜗	勿 虫 ⻏ 
𨜘	屋 ⻏ 
𨜛	叜 ⻏ 
𨜜	省 ⻏ 
𨜩	泉 ⻏ 
𨜫	矦 ⻏ 
𨜰	姜 ⻏ 
𨜱	𡧱 ⻏ 
𨜳	宮 ⻏ 
𨜴	盍 ⻏ 
𨜵	𥁕 ⻏ 
𨜶	益 ⻏ 
𨜷	旁 ⻏ 
𨜺	翁 ⻏ 
𨜻	虔 ⻏ 
𨜼	栗 ⻏ 
𨜽	扅 ⻏ 
𨜾	倉 ⻏ 
𨜿	祟 ⻏ 
𨝀	鬼 ⻏ 
𨝆	哥 ⻏ 
𨝈	亻 弆 ⻏ 
𨝋	祭 ⻏ 
𨝌	乾 ⻏ 
𨝎	康 ⻏ 
𨝏	离 ⻏ 
𨝐	參 ⻏ 
𨝑	貫 ⻏ 
𨝓	票 ⻏ 
𨝖	邕 來 
𨝘	虖 ⻏ 
𨝛	荼 ⻏ 
𨝜	幸 廴 ⻏ 
𨝞	虍 𠂠 邑 
𨝟	禾 攵 厂 邑 
𨝢	㝡 ⻏ 
𨝦	堂 邑 
𨝨	措 ⻏ 
𨝩	𨊴 邑 
𨝫	翕 ⻏ 
𨝭	馮 ⻏ 
𨝮	棸 ⻏ 
𨝯	童 ⻏ 
𨝰	喬 ⻏ 
𨝱	焦 ⻏ 
𨝲	臯 ⻏ 
𨝳	貲 ⻏ 
𨝴	黃 ⻏ 
𨝵	林 月 ⻏ 
𨝸	覃 ⻏ 
𨞎	口 軍 ⻏ 
𨞐	盛 ⻏ 
𨞑	邕 臭 
𨞒	稓 ⻏ 
𨞓	奧 ⻏ 
𨞕	蜀 ⻏ 
𨞗	羣 ⻏ 
𨞘	䖒 ⻏ 
𨞙	豦 ⻏ 
𨞛	葛 ⻏ 
𨞠	𨛜 共 
𨞣	歲 ⻏ 
𨞨	蓋 ⻏ 
𨞩	翟 ⻏ 
𨞪	壽 ⻏ 
𨞫	蒙 ⻏ 
𨞰	𨛜 皂 
𨞲	龵 馬 ⻏ 
𨞳	鼻 ⻏ 
𨞶	自 果 ⻏ 
𨞷	夭 夭 虫 ⻏ 
𨞺	厲 ⻏ 
𨞻	麃 ⻏ 
𨞼	蔓 ⻏ 
𨞽	畾 ⻏ 
𨞾	興 ⻏ 
𨞿	羮 ⻏ 
𨟂	艹 魚 ⻏ 
𨟃	徵 ⻏ 
𨟄	樊 邑 
𨟊	質 ⻏ 
𨟏	𤎭 ⻏ 
𨟐	㙶 ⻏ 
𨟑	歷 ⻏ 
𨟖	磨 ⻏ 
𨟗	蔿 ⻏ 
𨟙	嬰 ⻏ 
𨟚	襄 ⻏ 
𨟥	𰘾 ⻏ 
𨟦	𠨧 ⻏ 
𨟲	弋 酉 
𨟴	酉 勻 
𨟵	酉 比 
𨟶	戈 酉 
𨟸	酉 勿 
𨟹	酉 今 
𨟺	酉 丏 
𨟼	酉 亢 
𨟽	火 酉 
𨟾	酉 氏 
𨠋	酉 瓜 
𨠌	酉 冬 
𨠎	酉 令 
𨠏	酉 氐 
𨠐	酉 此 
𨠑	酉 㐌 
𨠓	酉 𠂔 
𨠔	酉 必 
𨠖	酉 包 
𨠟	酉 平 
𨠡	酉 㞋 
𨠤	酉 戎 
𨠥	酉 危 
𨠦	酉 交 
𨠬	酉 老 
𨠭	合 酉 
𨠶	酉 色 
𨠸	酉 巠 
𨠹	酉 大 朩 
𨠿	酉 夾 
𨡁	酉 見 
𨡂	酉 希 
𨡃	酉 夆 
𨡄	酉 言 
𨡌	酉 委 
𨡍	酉 沓 
𨡎	酉 念 
𨡏	酉 典 
𨡐	制 酉 
𨡑	酉 周 
𨡒	酉 勹 𦈢 
𨡓	爿 𱼀 酉 
𨡗	酉 穹 
𨡞	酉 靣 
𨡡	酋 巳 亼 
𨡢	酓 欠 
𨡣	念 酉 
𨡤	酉 亠 因 
𨡩	酉 癹 
𨡫	酉 軍 
𨡬	酉 泴 
𨡭	敄 酉 
𨡮	酉 怱 
𨡱	酉 苦 
𨡲	酉 秋 
𨡴	酉 酋 
𨡸	酉 苶 
𨡻	酉 叜 
𨢂	酉 胤 
𨢅	酋 卒 
𨢆	酉 桑 
𨢇	酉 留 
𨢈	𠦝 酋 
𨢉	酉 豈 
𨢊	酉 冡 
𨢋	𣪊 酉 
𨢌	酉 鬲 
𨢎	酉 冥 
𨢐	酉 旁 
𨢑	酉 兼 
𨢜	酉 隺 
𨢠	酉 宀 乃 皿 
𨢡	酉 畢 
𨢢	酉 莫 
𨢣	酉 頃 
𨢤	殸 酉 
𨢥	酉 曼 
𨢦	酉 責 
𨢩	酉 𬀷 
𨢪	酉 巢 
𨢬	酉 荼 
𨢮	𥎿 酉 
𨢯	淰 酉 
𨢵	酉 祭 
𨢸	酉 盖 
𨢹	皮 刑 酉 
𨢿	酉 單 
𨣀	酉 尞 
𨣁	酉 善 
𨣂	酉 蛬 
𨣃	酉 勞 
𨣄	酉 華 
𨣅	酉 最 
𨣇	酉 閒 
𨣈	酉 貴 
𨣉	酉 間 
𨣍	酉 奢 
𨣔	酉 叅 
𨣕	酉 次 皿 
𨣗	𣪠 酉 
𨣘	酉 宓 皿 
𨣙	酉 雹 
𨣚	酉 亶 
𨣛	酉 尚 甘 
𨣝	酉 感 
𨣠	酉 ⺫ 𡗜 干 
𨣢	酉 遂 
𨣦	酉 與 
𨣧	酉 齊 
𨣨	酉 監 
𨣬	酉 雨 厂 巴 
𨣯	酉 鼏 
𨣱	酉 蔑 
𨣵	酉 賛 
𨣸	酉 覧 
𨣻	嬐 酉 
𨣾	彌 酉 
𨤂	酉 醟 
𨤃	酉 藏 
𨤄	酉 𥳑 
𨤇	酉 𣍘 
𨤋	酉 覽 
𨤎	酉 鹽 
𨤑	釆 𠬞 
𨤕	釆 奄 
𨤘	釆 枼 
𨤚	釆 冓 
𨤡	釆 廣 
𨤢	少 里 
𨤤	里 也 
𨤩	必 里 
𨤫	𠅃 里 
𨤱	是 里 
𨤲	𭆆 里 
𨤴	重 疌 
𨤹	重 集 
𨤽	金 匕 
𨥂	金 孑 
𨥇	金 寸 
𨥍	金 凶 
𨥑	金 卝 
𨥙	金 井 
𨥛	金 互 
𨥞	金 𠆢 十 
𨥣	凵 厶 金 
𨥦	金 𠂔 
𨥧	金 乏 
𨥨	金 矛 
𨥪	金 十 丶 丶 丶 
𨥴	石 金 
𨥶	金 代 
𨥸	金 匈 
𨥺	金 弘 
𨦂	金 礼 
𨦃	金 朶 
𨦄	金 㕂 
𨦆	金 㫐 
𨦕	金 㓝 
𨦖	金 𫠥 
𨦗	金 灰 
𨦛	金 伏 
𨦜	金 爫 丂 
𨦞	金 舟 
𨦡	金 羊 
𨦭	金 牢 
𨦮	汲 金 
𨦯	金 役 
𨦰	金 丣 
𨦱	金 囱 
𨦳	金 内 口 
𨧀	金 杜 
𨧐	金 吞 
𨧑	金 爫 工 
𨧕	金 言 
𨧖	金 床 
𨧗	金 方 彡 
𨧙	金 弔 口 
𨧥	金 些 
𨧦	陂 金 
𨧧	金 豖 
𨧨	金 芮 
𨧪	金 帚 
𨧫	金 事 
𨧭	禾 士 金 
𨧰	金 乖 
𨧱	金 屈 
𨧳	制 金 
𨧵	金 凵 又 𡈼 
𨨏	金 波 
𨨕	金 参 
𨨗	林 金 
𨨘	金 臤 
𨨙	金 匚 𢆶 
𨨚	金 少 火 
𨨛	金 和 
𨨜	金 乳 
𨨠	金 匊 
𨨡	金 於 
𨨢	金 炊 
𨨬	巛 万 刂 金 
𨨭	金 艹 双 
𨨯	金 奏 
𨨰	金 耎 
𨨱	金 活 
𨨲	金 持 
𨨳	金 夂 缶 
𨨴	金 𥄉 
𨨶	金 卸 
𨨷	金 突 
𨨸	金 䖟 
𨨹	金 耷 
𨨺	削 金 
𨩀	金 矦 
𨩥	金 封 
𨩦	金 苟 
𨩧	南 金 
𨩨	金 查 
𨩩	金 冒 
𨩪	金 山 虫 
𨩫	金 便 
𨩬	金 囟 大 
𨩯	金 勉 
𨩰	金 㚅 
𨩲	金 咨 
𨩴	金 穿 
𨩵	金 穴 反 
𨩶	金 冠 
𨩸	金 㢲 
𨩻	金 凵 又 八 夂 
𨩽	金 虐 
𨪄	土 向 金 
𨪅	鈹 毛 
𨪈	金 鬼 
𨪉	金 虒 
𨪊	金 㕚 虫 
𨪌	金 耆 
𨪍	金 娑 
𨪎	金 彧 
𨪏	金 疾 
𨪑	錢 刂 
𨪒	金 𠳯 
𨪕	金 芻 
𨪗	金 笍 
𨪳	金 䎡 
𨪶	金 晏 
𨪷	金 骨 
𨪹	金 先 王 
𨪾	金 𰲚 
𨪿	金 夗 由 
𨫀	金 展 
𨫁	金 癶 口 又 
𨫒	金 屚 
𨫔	埶 金 
𨬁	金 䒑 巾 升 丶 
𨬍	金 隋 
𨬐	厥 金 
𨬑	厤 金 
𨬒	金 敢 
𨬔	金 閏 
𨬕	金 古 幸 
𨬖	金 孱 
𨬗	金 須 
𨬚	金 黹 
𨬝	坴 丮 金 
𨭃	金 牚 
𨭅	金 山 𠫓 冉 
𨭆	金 黑 
𨭌	金 彭 
𨭎	金 喜 
𨭓	金 𢦏 吉 
𨭖	金 亶 
𨭗	金 會 
𨭚	金 剽 
𨭛	金 葛 
𨭺	金 禁 
𨮁	金 粤 
𨮂	金 解 
𨮔	金 與 
𨮪	爾 金 
𨮬	鏢 寸 
𨮭	金 厂 斯 
𨮴	金 登 儿 
𨮸	金 劉 
𨮹	金 適 
𨮺	金 𥝌 尤 旨 
𨮻	金 廛 
𨮿	金 箸 
𨯀	金 稽 
𨯓	金 蔡 
𨯞	彊 金 
𨯟	金 霍 
𨯲	金 頭 
𨯽	金 篱 
𨰂	金 薦 
𨰆	金 穴 瓜 瓜 瓜 
𨰋	金 禮 
𨰏	金 闒 
𨰑	金 藋 
𨰓	金 𥳑 
𨰜	金 爵 
𨰞	金 靡 
𨰠	金 羸 
𨰦	金 寳 
𨰭	金 纂 
𨰵	轟 金 
𨰸	金 言 韯 
𨰾	钅 马 
𨰿	钅 乞 
𨱀	钅 互 
𨱁	钅 殳 
𨱂	钅 化 
𨱃	钅 瓜 
𨱄	钅 出 
𨱅	钅 㐱 
𨱈	钅 束 
𨱉	钅 京 
𨱊	钅 屈 
𨱋	钅 夌 
𨱌	钅 贯 
𨱍	钅 郎 
𨱎	钅 俞 
𨱐	钅 屚 
𨱒	钅 欶 
𨱓	钅 焦 
𨱕	钅 解 
𨱖	钅 微 
𨱙	镸 几 
𨱚	镸 殳 
𨱛	镸 公 
𨱜	镸 支 
𨱝	镸 攵 
𨱡	镸 氏 
𨱣	镸 㕛 
𨱤	镸 冗 
𨱦	镸 出 
𨱧	镸 幼 
𨱫	镸 甘 
𨱭	镸 号 
𨱮	镸 𪠲 
𨱯	镸 尒 
𨱱	镸 母 
𨱵	镸 兆 
𨱺	镸 士 廾 
𨱻	镸 吉 
𨱼	死 長 
𨱿	镸 戎 
𨲀	镸 弄 
𨲁	镸 夭 小 
𨲄	镸 厶 小 又 
𨲆	镸 肖 
𨲈	镸 隹 
𨲉	镸 垂 
𨲊	镸 岸 
𨲋	镸 卑 
𨲎	镸 易 
𨲐	镸 夂 丕 
𨲑	镸 刀 又 云 
𨲒	镸 录 
𨲓	镸 省 
𨲗	壴 長 
𨲛	镸 首 
𨲜	镸 扁 
𨲞	镸 剔 
𨲟	镸 容 
𨲧	镸 從 
𨲪	镸 責 
𨲫	镸 逢 
𨲬	镸 𭄶 
𨲭	镸 喬 
𨲮	镸 勞 
𨲯	镸 曾 
𨲰	镸 毛 朋 
𨲱	镸 叅 
𨲳	镸 農 
𨲵	镸 亶 
𨲿	镸 夂 貴 
𨳀	镸 褭 
𨳁	镸 龍 
𨳂	镸 毚 
𨳆	镸 囊 
𨳋	門 几 
𨳌	𠄟 門 
𨳑	門 亡 
𨳔	三 門 
𨳕	門 子 
𨳗	門 公 
𨳘	門 屯 
𨳙	門 內 
𨳚	門 分 
𨳛	門 及 
𨳝	門 壬 
𨳞	門 丑 
𨳠	門 冈 
𨳡	門 卝 
𨳣	門 兮 
𨳲	門 卞 
𨳷	門 它 
𨳺	門 失 
𨳻	門 宂 
𨳼	門 甘 
𨳿	門 外 
𨴀	門 冋 
𨴆	門 打 
𨴊	門 矢 
𨴌	門 厶 ⺕ 
𨴍	門 牟 
𨴎	門 而 
𨴏	門 同 
𨴐	門 先 
𨴑	門 匡 
𨴒	門 㓞 
𨴓	門 危 
𨴗	門 至 
𨴘	門 厶 丑 
𨴚	幵 門 
𨴛	門 老 
𨴜	門 有 
𨴞	門 年 
𨴡	門 兆 
𨴢	門 多 
𨴣	門 安 
𨴩	門 余 
𨴪	門 甫 
𨴬	門 告 
𨴭	門 甬 
𨴯	門 豕 
𨴰	門 作 
𨴹	門 孝 
𨴺	門 村 
𨴻	門 里 
𨴼	門 見 
𨴾	門 別 
𨵂	門 氏 巾 
𨵃	門 免 
𨵄	門 完 
𨵆	門 系 
𨵈	門 非 
𨵉	門 幸 
𨵊	門 戔 
𨵋	門 委 
𨵌	門 阿 
𨵍	門 沾 
𨵎	門 竒 
𨵐	門 股 
𨵗	門 卦 
𨵘	門 虎 
𨵚	門 果 
𨵛	門 明 
𨵝	門 沓 
𨵞	門 乖 
𨵟	門 服 
𨵠	門 屆 
𨵡	門 屈 
𨵤	門 奇 
𨵥	門 省 
𨵦	門 俞 
𨵧	門 咼 
𨵩	門 畐 
𨵪	門 頁 
𨵫	門 若 
𨵬	門 限 
𨵭	門 建 
𨵮	門 重 
𨵰	門 下 下 下 
𨵴	門 南 
𨵶	門 昜 
𨵸	門 便 
𨵼	門 𠁭 
𨶀	門 荅 
𨶁	門 晏 
𨶂	門 益 
𨶅	門 羔 
𨶆	門 倉 
𨶇	門 烏 
𨶈	門 唐 
𨶊	倠 門 
𨶐	門 适 
𨶔	門 ⺶ 𠬝 
𨶗	門 浪 
𨶜	門 㪷 
𨶝	門 孰 
𨶟	門 羽 𠆢 ⺕ 
𨶠	門 鳥 
𨶢	門 魚 
𨶨	門 側 
𨶪	門 翏 
𨶬	門 畫 
𨶭	門 無 
𨶮	門 壹 
𨶯	門 黑 
𨶰	門 黃 
𨶱	門 華 
𨶲	門 焦 
𨶺	門 淼 
𨶼	凵 亠 丷 閤 
𨶽	居 閏 
𨶿	門 登 
𨷀	門 絡 
𨷁	門 堯 
𨷃	門 遂 
𨷄	門 日 者 
𨷆	門 天 韭 
𨷇	門 溫 
𨷎	奓 閏 
𨷐	門 熅 
𨷒	門 𡺳 
𨷓	門 廌 
𨷔	門 熏 
𨷘	門 需 
𨷙	門 塾 
𨷥	門 失 𰋣 
𨷦	門 歷 
𨷩	門 頭 
𨷬	門 𠆢 爾 
𨷱	門 繇 
𨷲	門 龠 
𨷻	門 䜌 
𨷽	門 鹽 
𨷿	门 乡 
𨸀	门 子 
𨸁	门 亡 
𨸂	门 方 
𨸃	门 毛 
𨸄	门 艮 
𨸅	门 至 
𨸆	门 畐 
𨸇	门 便 
𨸉	门 荅 
𨸋	门 焦 
𨸌	门 壹 
𨸎	门 龠 
𨸐	⻖ 乃 
𨸑	⻖ 丂 
𨸒	⻖ 九 
𨸓	⻖ 刀 
𨸔	⻖ 几 
𨸗	⻖ 干 
𨸘	⻖ 广 
𨸙	⻖ ⻏ 
𨸚	⻖ 及 
𨸛	⻖ 气 
𨸜	⻖ 殳 
𨸝	⻖ 氏 
𨸟	⻖ 区 
𨸩	⻖ 攵 
𨸬	⻖ 申 
𨸭	⻖ 叵 
𨸮	⻖ 㕣 
𨸯	⻖ 瓜 
𨸰	⻖ 尻 
𨸱	⻖ 冉 
𨸷	𨸏 戶 乙 
𨸺	⻖ 甲 
𨸻	⻖ 夂 厶 
𨸼	⻖ 必 
𨹀	⻖ 此 
𨹁	⻖ 虫 
𨹃	⻖ 朶 
𨹅	⻖ 𠂤 
𨹆	⻖ 䏍 
𨹈	⻖ 𠆢 火 
𨹊	⻖ 众 
𨹋	⻖ 勹 王 
𨹌	⻖ 肉 
𨹔	⻖ 色 
𨹗	⻖ 并 
𨹘	⻖ 序 
𨹙	⻖ 吞 
𨹚	⻖ 成 
𨹜	⻖ 豆 
𨹝	⻖ 邑 
𨹟	⻖ 㔷 
𨹡	⻖ 又 九 土 
𨹵	⻖ 卷 
𨹶	⻖ 亝 
𨹸	⻖ 召 土 
𨹹	⻖ 朋 
𨹻	⻖ 典 
𨺀	𠂤 釆 𠃌 
𨺖	⻖ 尤 尤 
𨺚	𨸩 𠙻 
𨺝	⻖ 叕 
𨺟	⻖ 貞 
𨺠	⻖ 盾 
𨺡	⻖ 㚇 
𨺢	⻖ 風 
𨺣	⻖ 段 
𨺤	⻖ 畐 
𨺥	⻖ 兗 
𨺦	⻖ 叜 
𨺧	⻖ 酋 
𨺨	⻖ 咢 
𨺩	⻖ 建 
𨺫	臾 𨸏 
𨺮	⻖ 厶 麦 
𨺵	𨸏 㒸 
𨺸	⻖ 昴 
𨺹	⻖ 秋 
𨺿	⻖ 耳 女 
𨻀	⻖ 𣬉 
𨻁	⻖ 息 
𨻂	⻖ 晏 
𨻃	⻖ 匪 
𨻄	⻖ 臬 
𨻆	⻖ 虒 
𨻊	陜 土 
𨻌	⻖ 𠂹 
𨻍	⻖ 祟 
𨻏	𨸏 夾 土 
𨻒	⻖ 烕 
𨻕	⻖ 斊 
𨻖	⻖ 敉 
𨻗	⻖ 桑 
𨻣	⻖ 原 
𨻤	陜 女 
𨻥	⻖ 㫫 
𨻧	⻖ 留 
𨻨	⻖ 𧴲 
𨻱	⻖ 崩 
𨻲	⻖ 虖 
𨻳	⻖ 焉 
𨻵	⻖ 崔 
𨻶	⻖ 𡭽 
𨻷	⻖ 康 
𨻺	⻖ 頃 
𨻻	⻖ 婁 
𨻼	⻖ 𡌦 
𨼇	降 生 
𨼈	⻖ 𥥭 
𨼉	⻖ 羽 肊 
𨼊	⻖ 無 
𨼋	⻖ 虛 
𨼌	⻖ 欽 
𨼍	⻖ 臯 
𨼎	⻖ 絕 
𨼐	⻖ 朁 
𨼑	⻖ 屠 
𨼒	⻖ 單 
𨼓	⻖ 智 
𨼔	⻖ 尋 
𨼣	⻖ 甘 罕 
𨼤	陳 欠 
𨼥	⻖ 最 
𨼪	⻖ 楚 
𨼫	⻖ 豦 
𨼬	⻖ 解 
𨼮	⻖ 詹 
𨼯	⻖ 貇 
𨼱	𨺅 夬 
𨼽	𠂤 豦 
𨼿	⻖ 蒙 
𨽀	⻖ 厭 
𨽁	⻖ 聚 
𨽂	⻖ 僕 
𨽄	𨺅 吏 
𨽉	⻖ 署 
𨽊	⻖ 免 免 
𨽌	⻖ 𤔌 木 
𨽍	⻖ 賣 
𨽏	⻖ 廣 
𨽐	⻖ 𠒶 
𨽑	⻖ 爫 𢒗 
𨽖	⻖ 褭 
𨽗	⻖ 頻 
𨽝	𨺅 廿 冄 
𨽟	⻖ 遺 
𨽥	⻖ 步 馬 
𨽦	⻖ 聶 
𨽧	⻖ 雚 
𨽨	⻖ 鬵 
𨽯	⻖ 𰲚 𰲚 
𨽲	⻖ 靈 
𨽵	𨺅 㸂 
𨽷	亥 隶 
𨽸	镸 隶 
𨽹	𠤕 隶 
𨽻	𥘈 隶 
𨽿	枲 隶 
𨾂	隶 異 
𨾅	七 隹 
𨾉	久 隹 
𨾊	工 隹 
𨾌	于 隹 
𨾎	隹 夨 
𨾒	亢 隹 
𨾓	戈 隹 
𨾔	方 隹 
𨾚	夫 隹 
𨾛	氏 隹 
𨾡	申 隹 
𨾤	失 隹 
𨾦	氐 隹 
𨾬	左 隹 
𨾯	奴 隹 
𨾰	厶 干 隹 
𨾴	吅 隹 
𨾻	隹 劣 
𨾾	兆 隹 
𨿁	𤓳 隹 
𨿇	隹 肉 
𨿏	巫 隹 
𨿐	寽 隹 
𨿛	隹 希 
𨿠	垂 隹 
𨿡	享 隹 
𨿢	東 隹 
𨿭	⻖ 左 隹 
𨿳	𤕫 倠 
𨿿	重 隹 
𩀋	耎 隹 
𩀖	衣 口 隹 
𩀜	骨 隹 
𩀞	倉 隹 
𩀠	𣪊 隹 
𩀣	句 句 隹 
𩀧	斬 隹 
𩀪	麻 隹 
𩀫	區 隹 
𩀲	尸 隹 炙 
𩀶	隋 隹 
𩀼	𢽳 隹 
𩀿	朁 隹 
𩁌	隓 隹 
𩁞	蔡 隹 
𩁟	黎 隹 
𩁯	瞿 隹 
𩁴	雥 匊 
𩁷	雨 丁 
𩁹	雨 于 
𩁺	雨 彡 
𩁿	雨 𰀄 
𩂂	雨 勿 
𩂃	雨 夬 
𩂄	雨 屯 
𩂆	雨 不 
𩂈	雨 心 
𩂉	雨 天 
𩂍	雨 水 
𩂎	雨 父 
𩂒	雨 𢀴 
𩂓	雨 冬 
𩂔	雨 犮 
𩂕	雨 弗 
𩂖	雨 乍 
𩂗	雨 出 
𩂙	雨 𠆢 夕 
𩂝	雨 史 
𩂞	雨 卯 
𩂢	雨 乑 
𩂣	雨 各 
𩂤	雨 舟 
𩂥	雨 因 
𩂦	雨 并 
𩂧	雨 汚 
𩂨	雨 𠕋 
𩂪	雨 八 ⺝ 
𩂫	雨 夂 夂 
𩂴	雨 朿 
𩂵	雨 尸 巳 
𩂹	雨 役 
𩂻	雨 𦔮 
𩂼	雨 更 
𩂽	雨 弄 
𩂾	雷 丂 
𩂿	雨 君 
𩃀	雨 延 
𩃁	雨 沒 
𩃃	雨 厸 夂 
𩃋	雨 形 
𩃍	雨 㳂 
𩃎	雨 汸 
𩃐	雨 低 
𩃑	雨 扌 片 
𩃒	雨 垂 
𩃔	雨 㦰 
𩃕	雨 爿 木 
𩃖	雨 疌 
𩃙	雷 大 
𩃚	雨 泫 
𩃜	雨 泣 
𩃞	雨 𢨯 
𩃠	雲 内 
𩃡	雨 𦥔 
𩃬	雲 今 
𩃭	雨 松 
𩃯	雨 水 灬 
𩃰	雨 氵 㐌 
𩃱	雨 沱 
𩃴	雨 歹 月 
𩃵	雨 染 
𩃷	雲 代 
𩃹	雨 臿 
𩃺	雨 侯 
𩃾	雨 元 虫 
𩄅	雨 昷 
𩄊	雨 計 
𩄋	雨 洏 
𩄕	雨 昰 
𩄖	雨 彖 
𩄗	雨 正 乎 
𩄘	雨 翁 
𩄙	雨 圅 
𩄚	雨 眞 
𩄛	雨 陣 
𩄜	雨 索 
𩄝	雨 差 
𩄞	雨 秝 
𩄠	雨 真 
𩄡	雨 兼 
𩄢	雨 冓 
𩄦	雨 彳 夆 
𩄪	雨 一 由 火 
𩄬	雨 浼 
𩄮	雨 退 
𩄯	雺 目 
𩄷	雨 白 占 
𩄸	雨 任 攴 
𩄺	雨 哢 
𩄻	雨 莫 
𩄼	雨 渄 
𩄽	雨 婁 
𩄾	雨 責 
𩄿	雨 孛 攵 
𩅀	雨 執 
𩅁	雨 莽 
𩅃	雨 崇 
𩅄	雨 鹿 
𩅅	雨 洴 
𩅆	雨 辶 日 夂 
𩅇	雨 部 
𩅉	雨 眾 
𩅌	雨 尚 大 
𩅍	雨 曼 
𩅖	召 雨 幺 大 
𩅝	雲 奄 
𩅞	雩 重 
𩅠	雨 湳 
𩅡	雨 隋 
𩅢	雨 敫 
𩅣	雲 云 云 
𩅥	雨 隊 
𩅦	雨 單 
𩅧	雨 衆 
𩅨	雨 朁 
𩅩	雨 厤 
𩅪	雨 湘 
𩅮	雨 替 
𩅰	雨 斯 
𩅲	雨 巾 㒸 
𩅴	雨 渾 
𩅸	雨 畱 
𩅼	雨 僉 
𩅽	雨 農 
𩅾	雲 甚 
𩅿	雨 溥 
𩆀	雨 氵 隻 
𩆁	雨 會 
𩆂	雨 資 
𩆄	雨 雍 
𩆅	雨 䪞 
𩆆	雨 鼎 
𩆎	雨 溜 
𩆑	雨 酸 
𩆒	霝 囗 㐅 
𩆓	雨 漫 
𩆔	雨 墊 
𩆘	雨 𰀉 囗 缶 
𩆚	霝 𠕁 
𩆜	霝 玉 
𩆝	雨 厂 林 心 
𩆟	兔 需 
𩆣	雨 㼲 
𩆤	雨 潸 
𩆦	雲 曹 
𩆩	雨 澍 
𩆮	雨 器 
𩆯	雨 澰 
𩆱	雨 𧇨 
𩆲	雨 𪏵 
𩆵	雨 鮮 
𩆶	雨 襄 
𩆷	雨 韱 
𩆸	雨 濯 
𩆻	霝 囷 
𩆼	霝 泠 
𩆽	雨 懜 
𩆿	雨 雙 
𩇄	霝 音 
𩇇	雨 𦓈 
𩇎	霝 大 吅 土 
𩇏	雨 纖 
𩇐	雨 衢 
𩇕	青 彡 
𩇖	元 青 
𩇜	青 先 
𩇝	冫 靘 
𩇟	冫 靚 
𩇠	青 盍 
𩇣	青 瑟 
𩇩	大 非 
𩇫	非 子 
𩇮	非 手 
𩇯	非 巴 
𩇴	非 分 
𩇵	非 古 
𩇺	吞 非 
𩇻	非 忍 
𩇽	𰀕 非 
𩈁	隊 非 
𩈆	面 巴 
𩈇	面 丑 
𩈈	面 丰 
𩈉	面 冘 
𩈊	面 尤 
𩈋	面 介 
𩈍	面 旦 
𩈎	面 巧 
𩈏	面 幼 
𩈐	面 未 
𩈑	面 㞋 
𩈔	面 可 
𩈕	面 瓜 
𩈖	面 令 
𩈗	面 永 
𩈚	面 并 
𩈜	面 𠂤 
𩈞	面 𠃊 口 乂 
𩈡	面 巠 
𩈢	面 忍 
𩈣	面 含 
𩈤	面 足 
𩈦	面 免 
𩈬	面 官 
𩈭	面 宜 
𩈮	面 周 
𩈯	面 奄 
𩈱	宛 面 
𩈴	面 音 
𩈶	面 柰 
𩈸	面 臭 
𩈹	面 冥 
𩈺	面 烏 
𩈻	斬 面 
𩈼	面 參 
𩉀	淡 面 
𩉁	面 單 
𩉂	猒 面 
𩉄	面 然 
𩉆	面 女 面 
𩉋	面 慈 
𩉍	漸 面 
𩉐	面 察 
𩉔	面 韱 
𩉕	馘 面 
𩉗	面 瞿 
𩉙	面 羅 
𩉜	革 几 
𩉝	革 丸 
𩉡	革 介 
𩉢	革 欠 
𩉥	革 尹 
𩉧	革 丰 
𩉫	革 比 
𩉬	革 氏 
𩉯	革 元 
𩉰	革 帀 
𩉱	革 互 
𩉴	革 𠂆 㔾 
𩉵	革 分 
𩉸	革 巨 
𩉹	革 尼 
𩉺	革 它 
𩉼	革 申 
𩉽	革 弗 
𩉾	革 甲 
𩉿	革 句 
𩊀	革 白 
𩊁	革 夗 
𩊂	革 令 
𩊃	革 外 
𩊄	由 革 
𩊅	革 卯 
𩊇	革 玉 
𩊌	革 立 
𩊍	革 永 
𩊏	革 加 
𩊑	革 羊 
𩊓	革 夸 
𩊔	革 交 
𩊖	革 并 
𩊚	革 各 
𩊛	革 危 
𩊜	革 朵 
𩊝	革 旨 
𩊡	革 列 
𩊢	革 死 
𩊣	革 朱 
𩊤	革 丿 犮 
𩊨	革 丞 
𩊩	革 夆 
𩊪	革 豆 
𩊫	革 忍 
𩊬	革 甫 
𩊭	革 兌 
𩊮	革 沙 
𩊯	革 束 
𩊰	革 坒 
𩊴	革 志 
𩊵	革 大 日 
𩊶	革 步 
𩊺	革 角 
𩊻	革 夋 
𩊿	革 昔 
𩋁	革 叕 
𩋂	革 非 
𩋃	革 匋 
𩋄	革 取 
𩋅	革 忝 
𩋆	臤 革 
𩋈	革 𡿺 
𩋉	革 或 
𩋊	革 奄 
𩋋	革 戔 
𩋌	革 易 
𩋍	革 佻 
𩋏	革 念 
𩋒	革 朋 
𩋔	革 佳 
𩋗	革 果 
𩋘	革 隹 
𩋙	革 周 
𩋜	革 居 
𩋝	革 甾 
𩋞	革 𣏼 
𩋟	革 复 
𩋠	革 面 
𩋡	革 室 
𩋢	革 宣 
𩋣	革 帝 
𩋤	革 胃 
𩋧	革 皆 
𩋨	革 畐 
𩋩	革 致 
𩋪	革 苨 
𩋫	革 爰 
𩋬	革 昜 
𩋮	革 封 
𩋯	革 㚇 
𩋰	革 紂 
𩋱	革 𠆢 車 
𩋵	革 者 
𩋷	革 剌 
𩋺	革 勹 告 
𩋻	革 亯 
𩋽	革 客 
𩋾	革 韋 
𩋿	革 眉 
𩌃	革 鬼 
𩌄	革 芻 
𩌇	革 𦐇 
𩌈	革 索 
𩌉	革 泰 
𩌊	𣪊 革 
𩌌	革 貢 
𩌍	革 盍 
𩌏	革 尃 
𩌐	革 𥄳 
𩌑	革 冤 
𩌘	革 秦 
𩌝	革 追 
𩌠	革 匈 ⺝ 
𩌡	革 高 
𩌢	革 差 
𩌦	革 徙 
𩌧	革 莫 
𩌨	革 庸 
𩌩	革 崔 
𩌪	革 責 
𩌫	革 鹿 
𩌬	革 章 
𩌭	革 翏 
𩌯	革 覀 瓦 
𩌰	革 參 
𩌲	革 處 
𩌾	革 強 
𩍁	革 艹 勹 用 
𩍂	陶 革 
𩍃	革 買 
𩍅	革 童 
𩍆	革 舄 
𩍉	革 敢 
𩍋	革 覀 日 几 
𩍌	革 冑 寸 
𩍎	革 寒 
𩍏	革 富 
𩍐	革 登 
𩍓	革 雍 
𩍔	革 勹 麥 
𩍖	革 意 
𩍗	革 㬅 
𩍙	革 嗇 
𩍚	革 遂 
𩍜	革 睪 
𩍝	革 解 
𩍡	革 睘 
𩍥	革 需 
𩍦	革 爾 
𩍧	革 聚 
𩍨	革 匱 
𩍪	革 翟 
𩍳	革 木 尸 此 夂 
𩍵	革 質 
𩍷	啇 夬 革 
𩍸	竹 幸 勹 革 
𩍻	𩰵 革 
𩍼	革 盧 
𩍿	革 薄 
𩎂	革 日 月 殳 灬 
𩎃	革 燮 
𩎉	革 麗 
𩎊	革 羅 
𩎍	顯 革 
𩎎	革 𣡍 
𩎑	革 爨 
𩎒	韋 干 
𩎔	韋 爻 
𩎕	韋 及 
𩎖	韋 今 
𩎗	韋 欠 
𩎘	韋 包 
𩎙	韋 戉 
𩎚	韋 斥 
𩎛	韋 弗 
𩎜	韋 丕 
𩎟	韋 末 
𩎢	韋 𠬢 
𩎤	韋 艮 
𩎥	韋 曳 
𩎫	韋 朵 
𩎭	韋 亦 
𩎰	韋 兌 
𩎲	士 㓁 韋 
𩎳	歹 㐄 韋 
𩎵	佛 韋 
𩎷	韋 夂 灬 
𩎹	韋 或 
𩎻	韋 非 
𩎼	韋 陀 
𩎽	韋 沓 
𩎾	韋 庖 
𩏂	韋 卑 
𩏅	韋 爰 
𩏆	韋 宣 
𩏇	韋 段 
𩏈	韋 兗 
𩏉	亠 圍 夂 
𩏏	韋 𣐺 
𩏐	韋 鬼 
𩏑	𠦝 𠂉 韋 
𩏒	韋 荅 
𩏓	害 韋 
𩏖	韋 𡘝 
𩏗	拳 韋 
𩏘	韋 崔 
𩏚	韋 彗 
𩏝	韋 婁 
𩏞	韋 累 
𩏟	韋 𡌳 
𩏠	韋 登 
𩏡	韋 貴 
𩏣	虛 韋 
𩏤	韋 臯 
𩏥	韋 單 
𩏩	韋 僉 
𩏪	韋 睪 
𩏫	韋 嗇 
𩏬	韋 𠌶 
𩏭	韋 鉢 
𩏮	韋 槖 
𩏯	韋 蒪 
𩏲	韋 慧 
𩏴	木 缶 木 冖 韋 
𩏵	韋 薄 
𩏶	米 𤊙 韋 
𩏷	𥼚 韋 
𩏹	䜌 韋 
𩏺	韋 矍 
𩏼	韦 内 
𩏽	韦 𠬤 
𩏾	韦 𠬢 
𩏿	韦 是 
𩐀	韦 叚 
𩐁	歹 韭 
𩐅	䪞 攴 
𩐆	牙 欠 韭 
𩐉	口 韰 
𩐌	隊 韭 
𩐍	莫 韭 
𩐘	元 音 
𩐙	音 斤 
𩐚	音 弗 
𩐛	音 瓦 
𩐜	音 包 
𩐞	多 音 
𩐠	音 共 
𩐡	音 尗 
𩐣	音 光 
𩐤	音 同 
𩐥	音 合 
𩐦	音 巳 廾 
𩐨	音 夅 
𩐫	音 束 
𩐬	音 夂 火 
𩐭	音 念 
𩐮	音 虍 十 
𩐰	音 𠆢 亥 
𩐱	音 枼 
𩐴	亭 音 
𩐵	音 貢 
𩐶	音 巳 言 
𩐷	音 桒 
𩐻	音 莫 
𩐼	音 宿 
𩐾	音 条 支 
𩑀	音 菐 
𩑁	音 爲 
𩑂	音 蜀 
𩑃	音 業 
𩑇	音 吅 叕 
𩑈	音 廣 
𩑉	音 馬 念 
𩑊	音 靈 
𩑍	頁 𠄌 ⺃ 
𩑎	丿 丨 頁 
𩑐	义 頁 
𩑒	乇 頁 
𩑓	卂 頁 
𩑔	乞 頁 
𩑕	亐 頁 
𩑖	丸 頁 
𩑗	幺 頁 
𩑘	頁 彡 
𩑙	𡈼 頁 
𩑚	丰 頁 
𩑝	卬 頁 
𩑟	今 頁 
𩑡	气 頁 
𩑢	不 頁 
𩑣	尤 頁 
𩑤	午 頁 
𩑥	氏 頁 
𩑬	旡 頁 
𩑭	化 頁 
𩑮	勿 頁 
𩑯	斗 頁 
𩑰	旦 頁 
𩑳	平 頁 
𩑴	幼 頁 
𩑵	未 頁 
𩑶	古 頁 
𩑷	末 頁 
𩑸	可 頁 
𩑹	玄 頁 
𩑻	白 頁 
𩑼	叵 頁 
𩑾	氐 頁 
𩒀	尒 頁 
𩒂	它 頁 
𩒃	戊 頁 
𩒄	册 頁 
𩒇	兄 頁 
𩒈	頁 尒 
𩒊	主 頁 
𩒏	灰 頁 
𩒐	至 頁 
𩒓	共 頁 
𩒔	㞪 頁 
𩒕	屰 頁 
𩒖	幵 頁 
𩒘	充 頁 
𩒙	先 頁 
𩒚	光 頁 
𩒛	尗 頁 
𩒜	朶 頁 
𩒝	㫐 頁 
𩒞	工 止 頁 
𩒢	亘 頁 
𩒣	㕂 頁 
𩒦	臼 頁 
𩒧	須 巾 
𩒨	旨 頁 
𩒪	火 十 頁 
𩒮	求 頁 
𩒰	我 頁 
𩒳	𡿯 頁 
𩒴	汞 頁 
𩒵	匕 田 頁 
𩒷	車 頁 
𩒺	甫 頁 
𩒼	甬 頁 
𩒽	希 頁 
𩒾	吾 頁 
𩒿	尨 頁 
𩓂	弟 頁 
𩓅	角 頁 
𩓐	孛 頁 
𩓒	厂 令 頁 
𩓓	𥃩 頁 
𩓖	孚 頁 
𩓗	弃 頁 
𩓝	㡀 頁 
𩓞	爭 頁 
𩓟	臽 頁 
𩓠	支 木 頁 
𩓢	杲 頁 
𩓣	須 立 
𩓤	岸 頁 
𩓦	屈 頁 
𩓧	宜 頁 
𩓨	青 頁 
𩓪	彔 頁 
𩓫	卷 頁 
𩓬	勿 木 頁 
𩓮	火 木 頁 
𩓸	頁 支 木 
𩓺	炅 頁 
𩓻	山 甲 頁 
𩓼	山 用 頁 
𩓽	囷 頁 
𩔀	㒸 頁 
𩔁	面 頁 
𩔂	彖 頁 
𩔃	爰 頁 
𩔄	吉 夨 頁 
𩔆	癸 頁 
𩔇	皇 頁 
𩔈	革 頁 
𩔉	昬 頁 
𩔊	頁 頁 
𩔋	爯 頁 
𩔔	禹 頁 
𩔕	酋 頁 
𩔗	米 女 頁 
𩔘	勇 頁 
𩔙	𣬉 頁 
𩔚	翁 頁 
𩔝	衾 頁 
𩔞	圅 頁 
𩔟	㕋 頁 
𩔠	眛 頁 
𩔡	𠁁 頁 
𩔢	迷 頁 
𩔣	旃 頁 
𩔥	素 頁 
𩔦	追 頁 
𩔮	班 頁 
𩔱	益 頁 
𩔳	責 頁 
𩔴	鹿 頁 
𩔵	婪 頁 
𩔶	麻 頁 
𩔷	莫 頁 
𩔸	區 頁 
𩔹	須 卑 
𩔻	須 咅 
𩔼	庶 頁 
𩕀	敖 頁 
𩕄	悤 頁 
𩕆	章 頁 
𩕉	童 頁 
𩕊	善 頁 
𩕌	森 頁 
𩕍	臯 頁 
𩕏	番 頁 
𩕐	尞 頁 
𩕕	萠 頁 
𩕖	𡬳 頁 
𩕜	逵 頁 
𩕟	業 頁 
𩕠	𤊸 頁 
𩕡	嗇 頁 
𩕪	睘 頁 
𩕬	鼻 頁 
𩕭	蓋 頁 
𩕯	壽 頁 
𩕱	蒙 頁 
𩕲	旖 頁 
𩕳	寧 頁 
𩕵	出 𠆢 頁 言 
𩕹	蒼 頁 
𩕺	𧱏 頁 
𩕾	𡙷 頁 
𩖀	𥈜 頁 
𩖁	齒 頁 
𩖄	厱 頁 
𩖇	𥉾 頁 
𩖊	霝 頁 
𩖌	毚 頁 
𩖍	嬰 頁 
𩖒	原 願 
𩖓	𩕘 卑 
𩖔	頁 𪅝 
𩖕	须 立 
𩖖	炎 页 
𩖗	禁 页 
𩖛	風 凡 
𩖝	風 𠚣 
𩖠	風 女 
𩖣	文 風 
𩖤	風 屯 
𩖥	風 少 
𩖦	風 今 
𩖨	風 勿 
𩖩	風 𠕀 
𩖬	夫 風 
𩖭	風 巿 
𩖯	風 内 
𩖰	風 文 
𩖱	風 水 
𩖴	風 卯 
𩖵	風 令 
𩖶	風 朮 
𩖷	風 出 
𩖸	風 号 
𩖹	風 尼 
𩖺	風 甘 
𩖼	風 弗 
𩖽	風 皮 
𩖾	風 𡰥 
𩗀	風 白 
𩗄	風 共 
𩗅	風 刕 
𩗉	風 杀 
𩗊	風 吉 
𩗎	風 式 
𩗏	覀 風 
𩗐	風 米 
𩗑	風 𡰱 
𩗒	風 交 
𩗓	風 孛 
𩗔	妥 風 
𩗕	風 求 
𩗘	風 尾 
𩗙	風 折 
𩗚	風 攸 
𩗜	風 危 
𩗝	風 䖝 
𩗞	風 釆 
𩗢	風 汞 
𩗣	風 束 
𩗤	風 旱 
𩗥	風 邑 
𩗧	防 風 
𩗩	金 風 
𩗪	風 周 
𩗫	風 卑 
𩗭	風 戾 
𩗰	風 垂 
𩗱	風 析 
𩗲	風 爭 
𩗵	風 尚 
𩗶	風 卒 
𩗷	風 奄 
𩗺	風 易 
𩗼	風 青 
𩗽	風 亞 
𩗾	風 兩 
𩘀	風 卓 
𩘁	京 風 
𩘅	皆 風 
𩘇	風 訇 
𩘈	風 幽 
𩘊	風 剌 
𩘋	風 侯 
𩘍	兗 風 
𩘎	風 宮 
𩘏	風 枼 
𩘑	風 英 
𩘒	宣 風 
𩘓	風 斿 
𩘘	風 泉 
𩘜	風 唐 
𩘝	風 索 
𩘟	風 栗 
𩘠	夕 日 夕 風 
𩘡	風 茘 
𩘤	風 𤰔 曰 
𩘥	風 豈 
𩘧	風 射 
𩘭	風 羞 
𩘮	敖 風 
𩘯	風 專 
𩘰	風 宿 
𩘱	風 率 
𩘳	風 曹 
𩘵	風 鳥 
𩘹	風 肅 
𩘺	風 貴 
𩘻	風 矞 
𩘼	風 登 
𩘽	棠 風 
𩘿	風 𠷎 
𩙄	登 風 
𩙆	風 棠 
𩙇	風 隋 
𩙈	風 喿 
𩙏	壴 𠬢 風 
𩙐	檒 虫 
𩙑	風 巤 
𩙒	麃 風 
𩙖	風 歷 
𩙘	風 龍 
𩙙	風 盧 
𩙚	風 蕭 
𩙛	風 薨 
𩙜	燮 風 
𩙝	聶 風 
𩙠	風 風 龜 
𩙢	風 鬼 㒸 㒸 
𩙣	飌 习 习 习 流 
𩙥	风 犮 
𩙦	风 白 
𩙧	风 寿 
𩙨	风 肃 
𩙩	风 卓 
𩙪	风 炎 
𩙫	风 蚤 
𩙬	风 贵 
𩙭	风 索 
𩙮	风 高 
𩙯	风 黄 
𩙰	风 喿 
𩙲	牜 飛 
𩙷	高 飛 
𩙸	能 飛 
𩙺	飛 異 
𩙽	睘 飛 
𩙾	𪅝 飛 
𩚂	飠 ⺃ 
𩚄	飠 又 
𩚇	食 廾 
𩚈	飠 勺 
𩚉	飠 也 
𩚏	夕 食 
𩚕	飠 今 
𩚖	飠 丑 
𩚗	飠 冗 
𩚛	飠 內 
𩚣	飠 日 
𩚥	飠 巴 
𩚩	飠 古 
𩚪	飠 示 
𩚫	飠 正 
𩚬	飠 戶 乙 
𩚭	飠 付 
𩚮	飠 乏 
𩚯	飠 尼 
𩚱	飠 冋 
𩚲	飠 甲 
𩚵	飠 甘 
𩚹	飠 令 
𩚻	止 九 食 
𩚾	北 食 
𩚿	飠 丿 友 
𩛅	飠 𠆢 女 
𩛆	飠 㐌 
𩛇	飠 白 
𩛋	飠 𭗼 
𩛌	飠 大 女 
𩛎	飠 山 口 
𩛏	飠 士 女 
𩛑	飠 伎 
𩛘	飠 共 
𩛝	飠 寽 
𩛞	飠 孚 
𩛟	飠 免 
𩛠	飠 坐 
𩛡	飠 良 
𩛢	攸 食 
𩛥	才 飠 丮 
𩛦	飠 呈 
𩛧	飠 旱 
𩛨	飠 皃 
𩛩	飠 夾 
𩛪	飠 戶 乞 
𩛭	飠 育 
𩛮	飠 似 
𩛲	飠 芒 
𩛳	杋 食 
𩛵	飠 禾 力 
𩛶	飠 𠂆 古 
𩛹	飠 气 土 
𩛺	飠 匊 
𩛻	尸 氺 食 
𩛼	飠 彔 
𩛽	飠 匋 
𩛿	飠 易 
𩜀	飠 垂 
𩜁	飠 夌 
𩜃	飠 具 
𩜆	飠 𢆻 
𩜇	飠 卷 
𩜈	飠 芺 
𩜊	飠 甾 
𩜌	飠 宛 
𩜍	飠 東 
𩜒	乃 養 
𩜖	飠 山 尔 
𩜟	飠 昂 
𩜠	飠 岩 
𩜣	飠 𦍎 
𩜥	波 食 
𩜦	飠 定 
𩜧	飠 尸 夂 几 
𩜬	臤 食 
𩜭	飠 科 
𩜰	飠 畐 
𩜱	飠 甚 
𩜲	飠 复 
𩜳	飠 勇 
𩜵	飠 耑 
𩜶	飠 俞 
𩜷	飠 柔 
𩜸	祅 食 
𩜺	飠 訇 
𩜽	飠 彥 
𩝈	飠 咸 
𩝊	飠 是 
𩝌	飠 㒸 
𩝍	飠 矦 
𩝐	飠 兹 
𩝑	飠 宣 
𩝔	飠 胥 
𩝕	敄 食 
𩝖	𣧄 刂 食 
𩝗	飠 頁 
𩝚	飠 蚩 
𩝛	飠 害 
𩝝	飠 高 
𩝞	飠 倉 
𩝟	飠 臿 
𩝠	飠 臭 
𩝣	飠 𦐇 
𩝥	飠 素 
𩝷	飠 烏 
𩝸	飠 冤 
𩝽	飠 強 
𩝾	飠 商 
𩝿	飠 啇 
𩞀	飠 參 
𩞁	麻 食 
𩞃	飠 𬀷 
𩞄	飠 曹 
𩞅	飠 崔 
𩞆	飠 從 
𩞇	鹿 食 
𩞈	飠 逐 
𩞉	飠 崇 
𩞊	飠 既 
𩞋	飠 庸 
𩞑	飠 𠦪 
𩞙	飠 連 
𩞞	飠 口 旡 旡 
𩞣	𭈹 食 
𩞤	敦 食 
𩞥	飠 敞 
𩞦	飠 掌 
𩞧	飠 象 
𩞨	厤 食 
𩞩	飠 黃 
𩞬	飠 登 
𩞯	飠 量 
𩞶	飠 艹 ⻖ 厶 夫 
𩞷	飠 畱 
𩞺	周 欠 食 
𩞻	飠 粦 
𩞾	飠 蜀 
𩞿	飠 感 
𩟀	飠 雍 
𩟁	飠 睘 
𩟂	飠 過 
𩟃	飠 零 
𩟅	飠 僉 
𩟇	飠 奧 
𩟈	飠 當 
𩟉	飠 ⺫ 勹 圭 
𩟊	飠 農 
𩟋	飠 詹 
𩟍	飠 𡈏 
𩟐	飠 達 
𩟑	飠 𡷈 介 
𩟒	飠 穴 夌 
𩟓	飠 蒦 
𩟔	飠 察 
𩟕	飠 壽 
𩟗	漸 食 
𩟞	飠 夢 
𩟠	飠 麼 
𩟥	飠 嶲 
𩟦	飠 𢧵 
𩟧	飠 樂 
𩟨	周 谷 食 
𩟫	飠 叕 酉 
𩟭	飠 龍 
𩟮	飠 褱 
𩟰	飠 橐 
𩟳	飠 余 思 
𩟴	飠 𢿨 
𩟶	飠 韱 
𩟷	雝 食 
𩟸	𡧱 𡧱 食 
𩟺	飠 藍 
𩟿	⻠ 内 
𩠀	⻠ 巴 
𩠁	⻠ 甘 
𩠂	⻠ 㐌 
𩠃	⻠ 夹 
𩠆	⻠ 定 
𩠇	⻠ 迅 
𩠈	⻠ 念 
𩠉	⻠ 卷 
𩠊	⻠ 耑 
𩠋	⻠ 胥 
𩠌	⻠ 送 
𩠎	⻠ 曹 
𩠏	⻠ 掌 
𩠑	丁 首 
𩠚	首 亥 
𩠟	首 巳 个 
𩠦	肖 首 
𩠨	秇 首 
𩠮	首 冖 止 攴 
𩠯	首 姬 
𩠶	嫩 首 
𩠹	斷 首 
𩠻	香 今 
𩠽	香 木 
𩠾	疒 香 
𩠿	香 末 
𩡃	香 申 
𩡄	香 禾 
𩡎	香 幽 
𩡓	香 翁 
𩡔	香 害 
𩡕	旁 香 
𩡝	香 覃 
𩡟	香 业 冂 氺 
𩡠	黍 香 
𩡣	香 愛 
𩡦	香 𰀉 囗 缶 木 
𩡨	丿 馬 
𩡩	馬 八 
𩡫	⺇ 馬 
𩡭	馬 卜 
𩡯	馬 丁 
𩡷	犬 馬 
𩡺	馬 介 
𩡾	馬 少 
𩢄	馬 元 
𩢅	馬 戈 
𩢈	馬 𠤏 
𩢊	馬 力 力 
𩢌	文 馬 
𩢍	馬 瓜 
𩢎	馬 出 
𩢐	馬 乍 
𩢑	此 馬 
𩢒	馬 幼 
𩢔	馬 半 
𩢕	馬 本 
𩢖	馬 末 
𩢘	馬 叵 
𩢛	馬 匈 
𩢞	馬 卭 
𩢡	馬 冉 
𩢨	馬 甘 
𩢪	馬 古 
𩢫	生 馬 
𩢮	休 馬 
𩢯	馬 㠩 
𩢰	馬 伏 
𩢱	馬 回 
𩢲	馬 吏 
𩢳	羽 馬 
𩢴	馬 吉 
𩢵	馬 宅 
𩢷	馬 百 
𩢸	馬 舟 
𩢹	馬 臼 
𩢻	朱 馬 
𩢼	馬 匡 
𩢾	列 馬 
𩢿	馬 缶 
𩣊	馬 戍 
𩣖	馬 吝 
𩣘	馬 𦔮 
𩣚	馬 否 
𩣜	馬 𦈢 
𩣝	馬 步 
𩣞	馬 岌 
𩣡	馬 孛 
𩣣	我 馬 
𩣩	馬 折 
𩣫	馬 利 
𩣮	馬 兔 
𩣯	馬 沓 
𩣱	馬 坴 
𩣲	馬 典 
𩣳	馬 東 
𩣴	馬 广 去 
𩣵	馬 宛 
𩣶	明 馬 
𩣷	垂 馬 
𩣸	馬 阜 
𩣹	屈 馬 
𩣺	馬 奔 
𩣻	芺 馬 
𩣼	馬 空 
𩤁	馬 囷 
𩤈	馬 昔 
𩤉	馬 花 
𩤊	馬 戔 
𩤋	馬 𣏔 
𩤏	馬 卒 
𩤒	馬 宜 
𩤖	馬 𠒆 
𩤗	馬 癶 毛 
𩤘	馬 𡿺 
𩤙	馬 亭 
𩤚	馬 耑 
𩤛	馬 禺 
𩤜	馬 者 
𩤞	馬 罙 
𩤟	馬 昜 
𩤠	馬 皆 
𩤡	宣 馬 
𩤣	馬 段 
𩤤	面 馬 
𩤥	馬 咸 
𩤦	姦 馬 
𩤩	客 馬 
𩤲	馬 剌 
𩤸	馬 胃 
𩤹	馬 香 
𩤺	臾 馬 
𩤽	馬 虒 
𩥁	馬 唐 
𩥂	馬 耆 
𩥃	馬 冡 
𩥄	馬 真 
𩥅	馬 舀 
𩥆	馬 旅 
𩥇	馬 展 
𩥈	馬 𥁕 
𩥉	馬 豈 
𩥊	高 馬 
𩥌	馬 害 
𩥍	馬 羊 牛 
𩥐	馬 師 
𩥑	馬 𦐇 
𩥔	月 亠 水 馬 
𩥘	馬 峳 
𩥠	馬 荅 
𩥣	馬 䍃 
𩥫	馬 舂 
𩥬	馬 离 
𩥭	馬 魚 
𩥮	馬 產 
𩥯	殹 馬 
𩥲	馬 束 夫 
𩥴	馬 犁 
𩥽	馬 途 
𩥿	馬 宿 
𩦂	馬 閒 
𩦇	馬 喜 
𩦉	敝 馬 
𩦊	馬 寒 
𩦋	馬 幾 
𩦌	馬 喪 
𩦎	馬 斐 
𩦐	馬 善 
𩦘	馬 龷 隹 
𩦠	馬 剽 
𩦡	與 馬 
𩦢	馬 虞 
𩦤	馬 戢 
𩦱	馬 會 
𩦲	馬 𡕰 
𩦷	馬 截 
𩦹	馬 監 
𩦺	馬 蒙 
𩧁	馬 取 人 人 人 
𩧃	馬 厲 
𩧄	馬 質 
𩧅	馬 樊 
𩧆	馬 巤 
𩧇	馬 蔡 
𩧈	馬 賣 
𩧉	馬 廣 
𩧊	馬 敻 
𩧋	馬 黎 
𩧏	馬 霍 
𩧐	馬 橐 
𩧒	馬 禾 鳥 
𩧓	馬 蕭 
𩧘	馬 瞿 
𩧜	馬 轉 
𩧡	矍 馬 
𩧦	马 介 
𩧨	马 由 
𩧩	马 㦮 
𩧪	马 龙 
𩧫	马 央 
𩧬	马 冉 
𩧭	马 失 
𩧮	列 马 
𩧯	马 发 
𩧰	马 军 
𩧱	马 岂 
𩧲	马 同 
𩧳	马 舟 
𩧴	马 全 
𩧵	马 吉 
𩧺	马 局 
𩧻	马 宛 
𩧼	马 奔 
𩧿	马 畐 
𩨀	马 曷 
𩨁	马 春 
𩨃	马 建 
𩨄	马 叟 
𩨅	叟 胃 
𩨆	马 亭 
𩨇	马 娄 
𩨈	马 俞 
𩨉	马 剌 
𩨊	马 前 
𩨋	马 真 
𩨌	马 𦐇 
𩨍	马 展 
𩨏	马 番 
𩨐	马 巤 
𩨑	骨 丁 
𩨒	骨 几 
𩨓	骨 卜 
𩨔	九 骨 
𩨗	骨 亐 
𩨘	骨 乞 
𩨙	骨 弓 
𩨚	骨 女 
𩨜	骨 巴 
𩨝	骨 支 
𩨞	骨 及 
𩨟	骨 爻 
𩨠	骨 牙 
𩨡	骨 少 
𩨨	骨 比 
𩨩	骨 反 
𩨫	骨 尹 
𩨬	骨 玄 
𩨭	骨 它 
𩨮	屵 骨 
𩨯	骨 斥 
𩨲	骨 必 
𩨳	出 骨 
𩨴	骨 号 
𩨷	骨 山 匕 
𩨸	骨 出 
𩨹	骨 甲 
𩨻	骨 主 
𩨽	骨 𠂤 
𩨾	骨 危 
𩩀	骨 𭗼 
𩩄	骨 幵 
𩩅	骨 同 
𩩋	骨 巠 
𩩌	骨 系 
𩩑	骨 吾 
𩩒	骨 豕 
𩩔	骨 足 
𩩗	骨 舍 
𩩘	於 骨 
𩩛	骨 奇 
𩩝	骨 空 
𩩞	骨 垂 
𩩟	骨 叕 
𩩠	骨 卒 
𩩡	骨 夌 
𩩢	骨 兒 
𩩤	骨 亞 
𩩥	骨 𣏼 
𩩧	骨 炎 
𩩮	骨 度 
𩩯	骨 扁 
𩩰	骨 皆 
𩩱	骨 叚 
𩩲	骨 曷 
𩩳	骨 重 
𩩴	骨 咸 
𩩶	骨 食 
𩩺	骨 泉 
𩩻	骨 盾 
𩩼	骨 彡 䏍 
𩩾	骨 戶 二 巳 
𩪀	骨 追 
𩪁	骨 鬼 
𩪂	骨 豈 
𩪃	骨 害 
𩪆	骨 骨 
𩪉	骨 鹿 
𩪊	骨 票 
𩪌	骨 逢 
𩪍	骨 區 
𩪎	骨 莽 
𩪐	骨 國 
𩪖	骨 畢 
𩪗	骨 厥 
𩪘	骨 童 
𩪛	骨 菐 
𩪟	骨 𠶷 
𩪢	骨 歆 
𩪣	骨 意 
𩪤	骨 業 
𩪥	骨 零 
𩪦	骨 隓 
𩪧	骨 辟 
𩪭	骨 蒦 
𩪮	骨 麼 
𩪱	骨 熏 
𩪴	骨 養 
𩪸	骨 歷 
𩪺	骨 曇 
𩪾	䜌 骨 
𩫀	高 夨 
𩫁	高 毛 
𩫂	高 孔 
𩫇	不 高 
𩫊	高 八 土 
𩫍	高 生 
𩫓	高 死 
𩫕	高 豕 
𩫚	高 㣇 
𩫠	𩫏 夬 
𩫥	巢 高 
𩫦	高 參 
𩫫	𩫏 卑 
𩫲	高 蟲 
𩫳	嚻 高 
𩫴	髟 九 
𩫹	髟 巾 
𩫺	髟 山 
𩬀	髟 內 
𩬍	髟 毋 
𩬏	髟 ⺝ 
𩬑	髟 占 
𩬔	髟 令 
𩬖	髟 㐱 
𩬗	髟 幼 
𩬙	髟 付 
𩬚	髟 甘 
𩬛	髟 工 几 
𩬜	髟 尻 
𩬝	髟 丙 
𩬞	髟 目 
𩬟	髟 乍 
𩬠	髟 台 
𩬤	髟 龙 
𩬫	髟 只 
𩬭	髟 失 
𩬮	髟 用 
𩬰	髟 工 卂 
𩬱	髟 兆 
𩬲	髟 曳 
𩬳	髟 肉 
𩬵	髟 印 
𩬷	髟 𭗼 
𩬸	髟 屰 
𩬹	髟 匡 
𩬺	髟 旨 
𩬻	髟 朵 
𩬼	髟 囗 夊 
𩬽	髟 𣎼 
𩭇	髟 里 
𩭊	髟 局 
𩭋	髟 困 
𩭌	髟 夾 
𩭏	髟 妥 
𩭐	髟 豕 
𩭑	髟 赤 
𩭒	髟 尨 
𩭓	髟 酉 
𩭘	髟 材 
𩭛	髟 角 
𩭝	髟 我 
𩭟	髟 卓 
𩭡	髟 昔 
𩭢	髟 岸 
𩭣	髟 沓 
𩭤	髟 忩 
𩭥	髟 臽 
𩭦	髟 垂 
𩭧	髟 卑 
𩭩	髟 東 
𩭫	髟 兩 
𩭯	髟 亞 
𩭲	髟 的 
𩭳	髟 忽 
𩭷	髟 來 
𩭺	髟 畐 
𩭼	髟 保 
𩭽	髟 客 
𩭾	髟 敄 
𩭿	髟 背 
𩮀	髟 怱 
𩮁	髟 丰 力 木 
𩮂	髟 曷 
𩮃	髟 叜 
𩮄	髟 秏 
𩮅	髟 奓 
𩮉	髟 𠃊 目 乂 
𩮎	髟 查 
𩮏	髟 咸 
𩮐	髟 禺 
𩮑	髟 咼 
𩮖	髟 豈 
𩮗	髟 竝 
𩮘	髟 高 
𩮚	髟 㕚 虫 
𩮛	髟 索 
𩮜	髟 剔 
𩮝	髟 害 
𩮠	髟 容 
𩮫	髟 殺 
𩮬	髟 翁 
𩮯	髟 敖 
𩮱	髟 舂 
𩮳	髟 票 
𩮴	髟 崔 
𩮵	殹 髟 
𩮶	髟 欶 
𩮷	髟 兜 
𩮸	髟 敕 
𩮹	髟 累 
𩯃	髟 費 
𩯄	髟 尊 
𩯆	髟 堯 
𩯇	髟 登 
𩯈	髟 戠 
𩯉	髟 最 
𩯊	髟 尞 
𩯋	髟 戟 
𩯌	髟 發 
𩯍	髟 菆 
𩯎	髟 盛 
𩯏	髟 菐 
𩯑	髟 叅 
𩯒	髟 㚘 贝 
𩯘	髟 喬 
𩯛	髟 敫 
𩯜	髟 虜 
𩯞	髟 粲 
𩯨	髟 爾 
𩯫	镸 彡 賔 
𩯰	髟 𢧵 
𩯱	髟 暴 
𩯲	髟 憃 
𩯳	髟 賛 
𩯺	髟 歷 
𩯽	髟 賴 
𩰀	髟 龍 
𩰃	髟 毚 
𩰍	鬥 卞 
𩰎	鬥 戈 
𩰓	鬥 巷 
𩰙	鬥 翕 
𩰞	鬥 爾 
𩰟	鬥 燹 
𩰠	鬯 疋 
𩰢	鬯 吏 
𩰤	矩 鬯 
𩰨	爫 尸 口 鬯 寸 
𩰪	𦥑 缶 鬯 彡 
𩰫	鬲 㐄 
𩰬	鬲 㐄 
𩰭	鬲 戈 
𩰯	鬲 古 
𩰱	羊 鬲 
𩰲	弜 鬲 
𩰳	鬲 圭 
𩰴	鬲 而 
𩰵	鬲 亘 
𩰶	鬲 亥 
𩰹	鬲 巠 
𩰻	鬲 求 
𩰽	𮫙 夋 
𩰾	沸 鬲 
𩱀	芏 八 口 𦉪 丅 
𩱁	𦍌 八 鬲 
𩱃	鬲 建 
𩱄	鬲 耎 
𩱆	𩰲 女 
𩱇	鬲 鬲 
𩱈	鬲 芻 
𩱊	鬲 䎡 
𩱋	羔 鬲 
𩱌	𩰲 主 
𩱍	𩰲 古 
𩱎	𩰲 弗 
𩱏	敖 鬲 
𩱓	𩰲 耳 
𩱘	鬲 裘 
𩱙	𥹷 鬲 
𩱚	𩰲 孛 
𩱝	鬲 衣 求 
𩱞	𩰲 孝 
𩱡	𩰲 侃 
𩱦	𩰲 芻 
𩱧	𩰲 羔 
𩱨	𩰲 辱 
𩱪	𩰲 且 丙 
𩱫	𩰲 速 
𩱬	𦥑 林 鬲 
𩱱	𩰲 毓 
𩱲	𩰲 翟 
𩱳	𩰲 齊 
𩱴	嚻 鬲 
𩱷	𩰲 𥽘 
𩱸	𥽘 䰜 
𩱻	鬼 卜 
𩱼	九 鬼 
𩱾	乇 鬼 
𩲁	鬼 夕 
𩲂	鬼 卪 
𩲃	鬼 勺 
𩲄	尢 鬼 
𩲅	鬼 寸 
𩲈	鬼 山 
𩲉	亡 鬼 
𩲊	鬼 毛 
𩲋	亢 鬼 
𩲌	方 鬼 
𩲍	鬼 牛 
𩲎	鬼 少 
𩲏	化 鬼 
𩲒	鬼 长 
𩲠	鬼 方 
𩲡	示 鬼 
𩲢	鬼 皮 
𩲣	甲 鬼 
𩲤	鬼 召 
𩲦	鬼 占 
𩲧	工 几 鬼 
𩲨	此 鬼 
𩲩	鬼 令 
𩲪	鬼 尔 
𩲬	鬼 一 勿 
𩲱	鬼 古 
𩲲	鬼 且 
𩲴	鬼 央 
𩲵	鬼 生 
𩲷	鬼 禾 
𩲹	鬼 仧 
𩲻	鬼 交 
𩲾	有 鬼 
𩳅	鬼 朱 
𩳆	鬼 耒 
𩳇	鬼 亻 殳 
𩳈	自 鬼 
𩳋	鬼 合 
𩳌	鬼 吾 
𩳍	鬼 巠 
𩳎	鬼 孚 
𩳏	豸 鬼 
𩳐	鬼 甫 
𩳑	鬼 沙 
𩳒	鬼 束 
𩳓	鬼 里 
𩳔	孝 鬼 
𩳝	呑 鬼 
𩳡	鬼 寽 
𩳢	鬼 奄 
𩳣	鬼 奇 
𩳤	鬼 長 
𩳥	豖 鬼 
𩳧	雨 鬼 
𩳨	鬼 占 寸 
𩳩	鬼 𥝢 
𩳯	鬼 旡 毛 
𩳲	鬼 侈 
𩳵	鬼 狊 
𩳶	枼 鬼 
𩳸	鬼 苗 
𩴀	鬼 者 
𩴁	鬼 咸 
𩴂	鬼 重 
𩴃	鬼 急 
𩴇	鬼 殺 
𩴈	眛 鬼 
𩴉	鬼 員 
𩴍	鬼 叟 
𩴐	鬼 率 
𩴑	鬼 參 
𩴒	強 鬼 
𩴓	鬼 𦰩 
𩴘	鬼 處 
𩴙	鬼 深 
𩴜	鬼 異 
𩴝	鬼 登 
𩴞	鬼 爲 
𩴟	奢 鬼 
𩴠	鬼 粦 
𩴣	厤 鬼 
𩴤	鬼 尞 
𩴧	鬼 焦 
𩴨	羊 羊 鬼 
𩴩	鬼 焱 
𩴪	幾 鬼 
𩴮	鬼 睪 
𩴱	賓 鬼 
𩴳	鬼 察 
𩴴	鬼 𡏳 
𩴵	鬼 監 
𩴹	鬼 翟 
𩴺	賣 鬼 
𩴻	畾 鬼 
𩵀	霝 鬼 
𩵄	鬼 雚 
𩵅	鬼 瞿 
𩵇	鬼 羅 
𩵉	鬼 𧃰 
𩵋	⺈ 田 大 
𩵍	魚 九 
𩵎	魚 又 
𩵏	魚 匕 
𩵓	魚 力 
𩵕	魚 刃 
𩵖	魚 小 
𩵗	魚 巳 
𩵚	魚 土 
𩵛	尢 魚 
𩵠	魚 牛 
𩵢	魚 欠 
𩵣	魚 不 
𩵥	魚 犬 
𩵦	魚 木 
𩵩	魚 夫 
𩵬	魚 斗 
𩵭	魚 王 
𩵮	少 魚 
𩵰	魚 火 
𩵱	魚 午 
𩵹	魚 父 
𩶁	魚 丙 
𩶂	魚 宁 
𩶄	魚 术 
𩶅	魚 氐 
𩶇	魚 矢 
𩶈	魚 乎 
𩶉	魚 布 
𩶎	魚 冉 
𩶑	魚 白 
𩶖	魚 目 
𩶛	魚 加 
𩶞	魚 亠 凡 
𩶡	魚 㠩 
𩶢	魚 牟 
𩶣	魚 舟 
𩶤	魚 先 
𩶥	魚 虫 
𩶦	魚 在 
𩶧	魚 臼 
𩶩	魚 肉 
𩶪	魚 至 
𩶫	魚 血 
𩶭	魚 口 夨 
𩶯	如 魚 
𩶱	魚 宅 
𩷁	魚 𠂬 
𩷂	魚 刕 
𩷄	魚 夅 
𩷋	魚 礼 
𩷌	魚 匕 木 
𩷍	魚 役 
𩷎	魚 狄 
𩷏	魚 巠 
𩷐	魚 局 
𩷑	魚 妟 
𩷓	魚 志 
𩷕	魚 良 
𩷖	魚 步 
𩷗	魚 狂 
𩷘	魚 岌 
𩷚	魚 孛 
𩷧	魚 赤 
𩷭	魚 夆 
𩷯	沃 魚 
𩷰	魚 迅 
𩷵	魚 吞 
𩷶	魚 芒 
𩷸	魚 𠂉 勹 方 
𩷹	魚 卓 
𩷻	魚 劼 
𩷼	魚 劵 
𩷽	魚 沓 
𩷾	魚 祁 
𩸀	魚 朋 
𩸁	魚 㡀 
𩸂	魚 忿 
𩸃	魚 兔 
𩸄	魚 果 
𩸇	亞 魚 
𩸋	魚 亞 
𩸎	魚 定 
𩸐	魚 乳 
𩸖	亞 魚 
𩸞	魚 奇 
𩸢	魚 𥝢 
𩸥	魚 炎 
𩸦	魚 泥 
𩸧	泥 魚 
𩸨	魚 宜 
𩸩	魚 宛 
𩸸	魚 妻 
𩸹	魚 弥 
𩸾	魚 耶 
𩸿	魚 癹 
𩹀	魚 奏 
𩹂	魚 胃 
𩹄	魚 曷 
𩹅	魚 英 
𩹇	魚 亭 
𩹈	魚 致 
𩹉	魚 飛 
𩹊	魚 斿 
𩹍	魚 癸 
𩹎	魚 音 
𩹏	魚 白 犬 
𩹑	魚 亼 虫 
𩹝	魚 毒 
𩹞	魚 南 
𩹟	魚 柰 
𩹢	魚 咼 
𩹥	魚 風 
𩹱	魚 畜 
𩹴	魚 舀 
𩹶	魚 唐 
𩹷	魚 鬼 
𩹸	魚 貢 
𩹺	魚 鬲 
𩹼	倝 魚 
𩹾	魚 納 
𩹿	魚 格 
𩺀	魚 脊 
𩺄	月 刑 魚 
𩺗	魚 荅 
𩺛	魚 虒 
𩺝	魚 逆 
𩺞	魚 桑 
𩺫	魚 隽 
𩺯	族 魚 
𩺲	魚 桼 
𩺵	魚 莘 
𩺼	魚 逋 
𩻉	埶 魚 
𩻋	魚 晜 
𩻌	魚 梨 
𩻗	魚 部 
𩻘	魚 閒 
𩻚	魚 無 
𩻛	魚 朁 
𩻜	猌 魚 
𩻝	魚 巽 
𩻟	魚 爲 
𩻡	魚 童 
𩻢	𠂹 厂 魚 
𩻤	魚 黑 
𩻧	魚 菓 
𩻱	魚 景 
𩻳	魚 棃 
𩻵	魚 翕 
𩻷	勝 魚 
𩻼	魚 彘 
𩼂	魚 遀 
𩼄	⺫ 魚 炎 
𩼅	魚 農 
𩼈	魚 奧 
𩼉	魚 當 
𩼊	𣎆 魚 
𩼋	魚 業 
𩼌	魚 微 
𩼒	魚 嗇 
𩼔	魚 廉 
𩼙	魚 葛 
𩼚	魚 艹 即 
𩼦	魚 聚 
𩼨	魚 疑 
𩼪	氵 𩺰 
𩼫	𦍌 魚 昔 
𩼭	㼲 魚 
𩼴	厭 魚 
𩼼	魚 廛 
𩽀	魚 誰 
𩽁	魚 麃 
𩽆	魚 賣 
𩽇	魚 憂 
𩽍	魚 韰 
𩽎	魚 遺 
𩽏	魚 歷 
𩽛	魚 薄 
𩽜	魚 蹇 
𩽝	魚 毚 
𩽞	魚 𥄳 弟 
𩽡	魚 擎 
𩽧	魚 雙 
𩽨	魚 巂 
𩽩	魚 瞿 
𩽰	魚 羅 
𩽳	魚 黨 
𩽴	魚 嚴 
𩽵	魚 蠡 
𩽷	魚 霸 
𩽺	鱼 夫 
𩽻	鱼 父 
𩽽	鱼 宅 
𩾁	鱼 求 
𩾂	鱼 寿 
𩾄	鱼 迅 
𩾅	鱼 兔 
𩾆	鱼 泥 
𩾇	鱼 虎 
𩾈	鱼 叔 
𩾊	鱼 疋 ⺝ 
𩾋	鱼 重 
𩾒	鳥 了 
𩾓	鳥 卩 
𩾔	七 鳥 
𩾕	匕 鳥 
𩾗	刁 鳥 
𩾘	㐅 鳥 
𩾚	丁 鳥 
𩾝	鳥 干 
𩾞	丸 鳥 
𩾠	己 鳥 
𩾡	鳥 勺 
𩾢	弋 鳥 
𩾧	鳥 川 
𩾬	鳥 工 
𩾳	鳥 丏 
𩾴	鳥 介 
𩾶	鳥 及 
𩾷	戈 鳥 
𩾸	仄 鳥 
𩾺	井 鳥 
𩾻	气 鳥 
𩾼	水 鳥 
𩾽	鳥 心 
𩾾	爻 鳥 
𩾿	父 鳥 
𩿀	中 鳥 
𩿂	毛 鳥 
𩿃	勻 鳥 
𩿄	爿 鳥 
𩿅	厷 鳥 
𩿈	分 鳥 
𩿉	鳥 分 
𩿊	月 鳥 
𩿑	旡 鳥 
𩿓	鳥 牛 
𩿔	反 鳥 
𩿕	仌 鳥 
𩿛	犬 鳥 
𩿝	巨 鳥 
𩿟	去 鳥 
𩿠	鳥 戉 
𩿡	鳥 台 
𩿢	主 鳥 
𩿣	末 鳥 
𩿤	札 鳥 
𩿥	尔 鳥 
𩿧	付 鳥 
𩿩	出 鳥 
𩿪	斥 鳥 
𩿬	由 鳥 
𩿷	示 鳥 
𩿺	瓦 鳥 
𩿽	㐌 鳥 
𩿿	刍 鳥 
𪀁	鳥 加 
𪀈	夗 鳥 
𪀉	可 鳥 
𪀊	鳥 句 
𪀏	鳥 巨 
𪀐	鳥 乏 
𪀒	鳥 至 
𪀓	鳥 多 
𪀔	鳥 寺 
𪀕	曳 鳥 
𪀖	尗 鳥 
𪀗	危 鳥 
𪀘	匠 鳥 
𪀚	鳥 戎 
𪀝	屰 鳥 
𪀞	巟 鳥 
𪀟	回 鳥 
𪀠	鳥 旬 
𪀣	杀 鳥 
𪀥	宅 鳥 
𪀦	式 鳥 
𪀧	老 鳥 
𪀩	多 鳥 
𪀪	休 鳥 
𪀬	灰 鳥 
𪀭	同 鳥 
𪀺	鳥 上 女 
𪀽	旬 鳥 
𪀾	舛 鳥 
𪀿	米 鳥 
𪁀	聿 鳥 
𪁈	庄 鳥 
𪁊	折 鳥 
𪁋	成 鳥 
𪁍	劫 鳥 
𪁎	肖 鳥 
𪁏	岑 鳥 
𪁐	利 鳥 
𪁑	兌 鳥 
𪁓	志 鳥 
𪁔	牢 鳥 
𪁕	沃 鳥 
𪁖	求 鳥 
𪁘	汪 鳥 
𪁛	役 鳥 
𪁜	良 鳥 
𪁞	豆 鳥 
𪁟	含 鳥 
𪁠	決 鳥 
𪁡	㐅 𠂇 子 鳥 
𪁥	豕 鳥 
𪁧	辰 鳥 
𪁩	鳥 弟 
𪁪	尨 鳥 
𪁮	秀 鳥 
𪁱	床 鳥 
𪁲	初 鳥 
𪁸	鳥 羌 
𪁹	鳥 非 
𪁺	尚 鳥 
𪁼	帛 鳥 
𪁽	卒 鳥 
𪁾	芺 鳥 
𪂀	鳥 斧 
𪂃	鳥 卑 
𪂄	侈 鳥 
𪂅	枝 鳥 
𪂆	昏 鳥 
𪂇	昌 鳥 
𪂈	炎 鳥 
𪂉	或 鳥 
𪂋	鳥 帚 
𪂌	沓 鳥 
𪂍	开 开 鳥 
𪂏	非 鳥 
𪂒	忽 鳥 
𪂓	岨 鳥 
𪂕	雨 鳥 
𪂚	鳥 坴 
𪂛	艹 氏 鳥 
𪂜	枚 鳥 
𪂟	㡀 鳥 
𪂠	果 鳥 
𪂤	命 鳥 
𪂦	宛 鳥 
𪂴	鳥 青 
𪂵	或 鳥 
𪂶	咸 鳥 
𪂹	春 鳥 
𪂺	急 鳥 
𪂼	相 鳥 
𪂽	盆 鳥 
𪂾	飠 鳥 
𪂿	鳥 是 
𪃂	流 鳥 
𪃄	思 鳥 
𪃅	削 鳥 
𪃆	鳥 奏 
𪃈	契 鳥 
𪃋	垔 鳥 
𪃍	禺 鳥 
𪃎	俞 鳥 
𪃏	某 鳥 
𪃐	鳥 眇 
𪃑	冒 鳥 
𪃒	度 鳥 
𪃓	負 鳥 
𪃛	彥 鳥 
𪃦	眇 鳥 
𪃧	眇 鳥 
𪃨	幽 鳥 
𪃭	客 鳥 
𪃶	侯 鳥 
𪃺	冓 鳥 
𪃼	息 鳥 
𪃾	容 鳥 
𪃿	哥 鳥 
𪄀	般 鳥 
𪄁	原 鳥 
𪄂	夏 鳥 
𪄅	殺 鳥 
𪄆	𣬉 鳥 
𪄈	鳥 秦 
𪄉	邕 鳥 
𪄊	䀠 鳥 
𪄌	貢 鳥 
𪄎	格 鳥 
𪄏	覀 分 鳥 
𪄑	穴 厶 夂 鳥 
𪄕	班 鳥 
𪄖	耆 鳥 
𪄛	鳥 息 
𪄝	鳥 烏 
𪄠	涑 鳥 
𪄭	桼 鳥 
𪄮	雩 鳥 
𪄯	規 鳥 
𪄱	啇 鳥 
𪄲	商 鳥 
𪄳	麥 鳥 
𪄴	敏 鳥 
𪄵	既 鳥 
𪄶	習 鳥 
𪄸	責 鳥 
𪄹	常 鳥 
𪄺	鳥 寇 
𪄻	鳥 舂 
𪄼	唯 鳥 
𪅀	堇 鳥 
𪅂	章 鳥 
𪅃	票 鳥 
𪅄	率 鳥 
𪅅	略 鳥 
𪅆	离 鳥 
𪅈	𠂹 一 鳥 
𪅉	臼 日 鳥 
𪅋	陵 鳥 
𪅍	淶 鳥 
𪅖	舂 鳥 
𪅙	敕 鳥 
𪅟	鳥 庸 
𪅡	鳥 翏 
𪅮	密 鳥 
𪅰	舒 鳥 
𪅲	翕 鳥 
𪅳	丣 田 鳥 
𪅴	惡 鳥 
𪅵	虫 次 鳥 
𪅸	絜 鳥 
𪅹	鳥 幾 
𪅺	喉 鳥 
𪅻	舟 龹 鳥 
𪅼	厤 鳥 
𪅾	欺 鳥 
𪆀	粥 鳥 
𪆁	斯 鳥 
𪆂	渠 鳥 
𪆄	鳥 焦 
𪆋	結 鳥 
𪆓	絲 鳥 
𪆖	鳥 壹 
𪆗	斯 鳥 
𪆛	虚 鳥 
𪆠	富 鳥 
𪆩	就 鳥 
𪆫	鳥 渠 
𪆯	農 鳥 
𪆰	葛 鳥 
𪆲	賈 鳥 
𪆳	鳥 雋 
𪆴	葵 鳥 
𪆵	淶 力 鳥 
𪆶	粲 鳥 
𪆷	鉏 鳥 
𪆹	過 鳥 
𪆻	詹 鳥 
𪆿	𧧑 鳥 
𪇁	當 鳥 
𪇂	士 冖 火 殳 鳥 
𪇆	鳥 蜀 
𪇇	僉 鳥 
𪇈	愛 鳥 
𪇊	鳥 辟 
𪇑	熏 鳥 
𪇒	精 鳥 
𪇓	夢 鳥 
𪇕	賓 鳥 
𪇖	監 鳥 
𪇗	穀 鳥 
𪇘	壽 鳥 
𪇛	㢕 鳥 
𪇜	𦵯 鳥 
𪇝	䳜 角 
𪇞	皷 鳥 
𪇬	與 鳥 
𪇭	蔡 鳥 
𪇯	戮 鳥 
𪇰	暴 鳥 
𪇱	樂 鳥 
𪇲	𢧵 鳥 
𪇳	鳥 箴 
𪇴	蔑 鳥 
𪇵	廣 鳥 
𪇷	鳥 辥 
𪈀	𠾧 鳥 
𪈁	箴 鳥 
𪈃	𩫏 鳥 
𪈅	竹 勹 幸 鳥 
𪈆	瞢 鳥 
𪈇	錢 鳥 
𪈈	頼 鳥 
𪈊	鬲 羽 鳥 
𪈋	亠 口 口 𢆉 夂 鳥 
𪈑	𩃮 鳥 
𪈒	鳥 盧 
𪈘	薨 鳥 
𪈜	縷 鳥 
𪈟	薛 鳥 
𪈥	巂 鳥 
𪈨	𪅝 身 
𪈩	鳥 雚 
𪈰	羅 鳥 
𪈴	矍 鳥 
𪈸	灌 鳥 
𪈻	權 鳥 
𪈿	蠻 鳥 
𪉔	𣬉 ⻦ 
𪉕	⻦ 箴 
𪉖	鹵 土 
𪉗	鹵 大 
𪉘	鹵 殳 
𪉚	鹵 毛 
𪉜	鹵 占 
𪉢	鹵 八 𠆢 十 
𪉣	鹵 豆 
𪉤	⺶ 鹵 
𪉦	鹵 臽 
𪉧	鹵 炎 
𪉨	鹵 昌 
𪉪	鹵 奉 
𪉭	鹵 畏 
𪉮	鹵 奏 
𪉯	鹵 甚 
𪉱	鹵 扁 
𪉸	鹵 𥁕 
𪉻	崇 鹵 
𪉿	鹵 敢 
𪊂	鹵 天 天 日 
𪊄	鹵 感 
𪊆	鹵 齊 
𪊇	鹵 監 
𪊉	鹵 褱 
𪊋	鹿 几 
𪊍	鹿 巳 
𪊐	鹿 夫 
𪊕	鹿 比 
𪊗	鹿 手 
𪊜	鹿 本 
𪊢	鹿 矢 
𪊥	鹿 亘 
𪊧	鹿 圭 
𪊨	鹿 旨 
𪊪	鹿 后 
𪊳	鹿 亦 
𪊵	鹿 巠 
𪊶	鹿 廷 
𪊷	鹿 孝 
𪊹	鹿 助 
𪊻	鹿 皿 八 
𪋁	鹿 豕 
𪋄	鹿 取 
𪋅	鹿 宛 
𪋆	鹿 昆 
𪋇	鹿 隹 
𪋉	鹿 雨 
𪋊	鹿 果 
𪋋	鹿 并 
𪋌	鹿 卒 
𪋍	甾 鹿 
𪋏	鹿 者 
𪋐	鹿 耎 
𪋑	鹿 者 
𪋖	鹿 風 
𪋗	鹿 迷 
𪋜	鹿 畢 
𪋝	鹿 速 
𪋡	鹿 菐 
𪋢	鹿 豕 目 
𪋧	鹿 䠶 
𪋫	鹿 業 
𪋬	鹿 虞 
𪋮	鹿 與 
𪋰	鹿 署 
𪋳	鹿 霊 
𪋺	鹿 𩴶 
𪋻	麤 土 
𪋾	麥 力 
𪌀	麥 了 
𪌂	麥 乇 
𪌄	麥 巳 
𪌅	麥 內 
𪌆	麥 反 
𪌈	麥 比 
𪌉	麥 斗 
𪌊	麥 夬 
𪌋	麥 屯 
𪌍	麥 斤 
𪌏	麥 攴 
𪌓	麥 殳 
𪌔	麥 目 
𪌘	麥 主 
𪌞	麥 玉 
𪌟	麥 乍 
𪌢	麥 同 
𪌣	麥 各 
𪌤	麥 𠂤 
𪌧	麥 吉 
𪌩	麥 舌 
𪌪	麥 兆 
𪌫	麥 多 
𪌬	麥 米 
𪌮	麥 沙 
𪌰	麥 孛 
𪌱	麥 利 
𪌳	麥 寽 
𪌵	麥 求 
𪌶	麥 束 
𪌷	麥 步 
𪌹	麥 希 
𪌺	麥 君 
𪌼	麥 匋 
𪌽	麥 昆 
𪌿	麥 念 
𪍁	麥 囷 
𪍂	麥 空 
𪍄	麥 彔 
𪍅	麥 夜 
𪍇	麥 隹 
𪍈	麥 卓 
𪍌	麥 咼 
𪍎	麥 科 
𪍏	麥 負 
𪍑	麥 酋 
𪍔	麥 巛 艮 
𪍗	麥 秋 
𪍛	麥 屑 
𪍝	麥 𥁕 
𪍟	麥 索 
𪍠	𣪊 麥 
𪍡	麥 尃 
𪍣	麥 婁 
𪍤	麥 莫 
𪍦	麥 連 
𪍧	旋 麥 
𪍨	麥 巢 
𪍩	麥 曼 
𪍪	麥 畢 
𪍲	麥 替 
𪍴	麥 粦 
𪍵	麥 覃 
𪍶	麥 善 
𪍸	麥 豦 
𪍹	麥 蜀 
𪍻	喿 麥 
𪍿	麥 廣 
𪎃	薛 麥 
𪎅	麥 薩 
𪎆	麥 羅 
𪎇	𣫞 麥 
𪎈	麦 弋 
𪎉	⻨ 贝 
𪎊	⻨ 少 
𪎋	⻨ 占 
𪎒	广 梵 
𪎔	麻 弓 
𪎗	麻 日 
𪎛	麻 夗 
𪎝	麻 本 
𪎞	麻 央 
𪎠	麻 多 
𪎣	麻 㐬 
𪎤	沃 麻 
𪎦	麻 林 
𪎨	俞 麻 
𪎫	靡 𠆢 
𪎭	麻 黍 
𪎮	靡 手 
𪎲	𣫞 麻 
𪎵	黃 亢 
𪎶	黃 屯 
𪎺	黃 斥 
𪎻	黃 丞 
𪎽	黃 充 
𪎾	黃 ⾆ 
𪏀	⻩ 至 
𪏂	黃 干 火 
𪏅	⻩ 巠 
𪏆	享 黃 
𪏇	黃 或 
𪏈	黃 昔 
𪏉	黃 定 
𪏊	黃 戔 
𪏋	黃 炎 
𪏍	𰮋 黃 
𪏏	⻩ 虍 丁 
𪏐	⻩ 虎 
𪏒	卑 黃 
𪏓	皇 黃 
𪏔	黃 頁 
𪏖	黃 巳 而 
𪏗	⻩ 扁 
𪏚	黃 員 
𪏟	⻩ 莫 
𪏠	⻩ 角 水 
𪏢	⻩ 康 
𪏤	黃 惑 
𪏦	黃 黍 
𪏨	黃 豊 
𪏩	⻩ 耑 火 
𪏪	⻩ 廣 
𪏫	⻩ 出 票 
𪏮	黍 女 
𪏲	黍 丑 
𪏳	黍 互 
𪏴	黍 斤 
𪏵	黍 勿 
𪏶	黍 包 
𪏸	黍 尼 
𪏺	黍 必 
𪏻	黍 古 
𪏼	黍 力 女 
𪏿	黍 朱 
𪐀	黍 多 
𪐂	黍 卷 
𪐃	黍 奉 
𪐄	黍 卑 
𪐅	𥝢 黍 
𪐆	黍 㡀 
𪐇	黍 㤐 
𪐈	黍 重 
𪐋	黍 兼 
𪐌	黍 匿 
𪐍	黍 連 
𪐎	黍 麻 
𪐏	黍 啇 
𪐓	黍 𬃷 
𪐔	黍 遺 
𪐖	黍 龍 
𪐘	黑 乙 
𪐝	黑 大 
𪐞	黑 乇 
𪐣	黑 子 
𪐥	黑 太 
𪐦	黑 亢 
𪐧	黑 予 
𪐬	黑 元 
𪐮	黑 殳 
𪐯	黑 勾 
𪐰	文 黑 
𪐲	黑 㐱 
𪐺	黑 禾 
𪐻	黑 付 
𪐿	黑 夅 
𪑀	黑 灰 
𪑂	黑 杀 
𪑃	黑 冊 
𪑆	黑 戍 
𪑈	黑 見 
𪑊	黑 肖 
𪑋	黑 寽 
𪑌	黑 谷 
𪑏	黑 余 
𪑐	尾 黑 
𪑒	黑 享 
𪑕	黑 昏 
𪑖	黑 奔 
𪑗	黑 妾 
𪑙	黑 金 
𪑚	黑 來 
𪑜	黑 知 
𪑝	黑 或 
𪑟	刺 黑 
𪑦	黑 曷 
𪑧	黑 枼 
𪑨	黑 柰 
𪑩	黑 𡱒 
𪑪	冠 黑 
𪑬	黑 亭 
𪑭	黑 奎 
𪑮	黑 南 
𪑯	黑 律 
𪑰	黑 屏 
𪑱	黑 屋 
𪑲	黑 冤 
𪑳	黑 貞 
𪑶	黑 柔 
𪑷	黑 𧆞 
𪑸	黑 頁 
𪑹	黑 界 
𪑻	黑 侯 
𪑽	黑 柴 
𪑾	黑 辱 
𪑿	黑 茲 
𪒀	般 黑 
𪒂	黑 𡗜 目 
𪒄	黑 冥 
𪒆	黑 秦 
𪒇	黑 夳 旦 
𪒉	黑 氣 
𪒊	黑 隻 
𪒋	黑 般 
𪒍	冧 黑 
𪒏	黑 鹿 
𪒑	黑 責 
𪒒	黑 庸 
𪒔	黑 离 
𪒕	異 黑 
𪒘	黑 登 
𪒙	黑 最 
𪒛	黑 隊 
𪒜	黑 惠 
𪒝	黑 雲 
𪒟	黑 曾 
𪒠	黑 敢 
𪒡	黑 逮 
𪒢	黑 菐 
𪒥	黑 越 
𪒩	黑 歲 
𪒪	黑 萬 
𪒫	黑 僉 
𪒬	黑 農 
𪒭	黑 禽 
𪒯	黑 葴 
𪒲	黑 業 
𪒴	黑 臺 
𪒹	黑 箴 
𪒼	黑 蔡 
𪒾	黑 𣊖 
𪒿	黑 駦 
𪓀	黑 歷 
𪓃	黑 襄 
𪓄	黑 毚 
𪓅	黑 藏 
𪓊	黑 鬱 
𪓋	黹 米 
𪓌	黹 卒 
𪓍	民 攴 黹 
𪓐	黹 虍 且 
𪓘	冄 黽 
𪓚	冉 黽 
𪓛	央 黽 
𪓜	皮 黽 
𪓡	大 口 黽 
𪓬	兒 黽 
𪓮	曷 黽 
𪓰	酋 黽 
𪓷	奚 黽 
𪓹	麻 黽 
𪓻	⺈ ⺫ 田 黽 
𪓼	亶 黽 
𪓿	爾 黽 
𪔅	口 鼎 
𪔆	鼎 干 
𪔊	鼎 彗 
𪔋	鼓 土 
𪔏	皷 井 
𪔑	鼓 石 
𪔔	鼓 夅 
𪔕	鼓 缶 
𪔗	鼓 因 
𪔘	鼓 吒 
𪔙	鼓 羊 
𪔟	鼓 豕 
𪔣	鼓 空 
𪔦	鼓 洞 
𪔩	鼓 咸 
𪔪	鼓 咠 
𪔰	殸 鼓 
𪔳	隆 鼓 
𪔶	鼓 僜 
𪔷	鼓 龍 
𪖐	鼻 ⺃ 
𪖕	牙 鼻 
𪖙	鼻 勾 
𪖚	鼻 占 
𪖛	鼻 丘 
𪖜	鼻 八 土 
𪖞	鼻 皮 
𪖢	鼻 圭 
𪖥	鼻 希 
𪖦	鼻 弟 
𪖩	鼻 一 血 
𪖯	鼻 扁 
𪖲	鼻 叚 
𪖳	鼻 兼 
𪖶	鼻 率 
𪖷	鼻 翏 
𪖼	鼻 朁 
𪗁	鼻 歷 
𪗂	鼻 毚 
𪗅	齊 又 
𪗆	广 齊 
𪗇	齊 ⺼ 
𪗉	齊 禾 
𪗋	齊 衣 
𪗍	齊 妻 
𪗏	齊 魚 
𪗒	齋 匕 目 𠃊 夂 
𪗔	齒 八 
𪗖	𠆢 齒 
𪗙	齒 干 
𪗜	齒 亢 
𪗝	齒 內 
𪗤	齒 丹 
𪗦	齒 占 
𪗧	齒 史 
𪗨	齒 出 
𪗪	齒 司 
𪗭	奴 齒 
𪗴	齒 宀 儿 
𪗵	齒 奴 
𪗷	齒 旨 
𪗸	齒 名 
𪗹	齒 圭 
𪗻	齒 至 
𪗽	齒 ⾆ 
𪗾	齒 吉 
𪗿	齒 列 
𪘀	齒 并 
𪘁	齒 合 
𪘃	齒 有 
𪘆	齒 休 
𪘇	齒 后 
𪘉	齒 朵 
𪘊	齒 各 
𪘎	齒 言 
𪘐	齒 我 
𪘑	齒 夋 
𪘒	齒 含 
𪘓	佐 齒 
𪘕	佗 齒 
𪘗	𬽲 齒 
𪘘	夾 齒 
𪘛	齒 耴 
𪘝	齒 辰 
𪘥	制 齒 
𪘦	臤 齒 
𪘧	齒 卒 
𪘨	齒 來 
𪘩	齒 囷 
𪘪	齒 戔 
𪘬	齒 厓 
𪘲	齒 宜 
𪘳	齒 屈 
𪘹	齒 曷 
𪘺	齒 客 
𪘾	齒 臿 
𪙃	齒 咼 
𪙈	狠 齒 
𪙉	齒 差 
𪙊	齒 兼 
𪙌	屑 齒 
𪙍	齒 尃 
𪙎	齒 倉 
𪙏	齒 害 
𪙑	齒 屑 
𪙛	齒 匿 
𪙞	齒 產 
𪙟	齒 堇 
𪙡	齒 曹 
𪙤	猌 齒 
𪙥	齒 禼 
𪙧	齒 幾 
𪙨	齒 間 
𪙫	齒 虛 
𪙭	齒 曾 
𪙳	齒 置 
𪙴	齒 義 
𪙺	齒 厲 
𪙽	齒 歷 
𪙾	齒 盧 
𪚁	聯 齒 
𪚃	齒 毚 
𪚅	齒 爵 
𪚇	齒 贊 
𪚏	齿 并 
𪚑	龍 巾 
𪚓	犭 龍 
𪚘	丹 龍 
𪚝	圭 龍 
𪚠	龍 巫 
𪚢	龍 飛 
𪚬	龜 今 
𪚭	龜 勾 
𪚮	冄 龜 
𪚯	火 龜 
𪚰	龜 灬 
𪚷	皮 龜 
𪚹	主 龜 
𪚻	央 龜 
𪛂	崔 龜 
𪛈	霝 龜 
𪛊	龠 斤 
𪛎	洎 龠 
𪛒	籥 殳 
𪜃	乚 一 口 ⺕ 
𪜅	木 丶 丶 井 
𪜆	𫠩 丮 
𪜥	㐭 𦣞 
𪜩	亻 勾 
𪜵	亻 旨 
𪜶	亻 因 
𪜺	亻 纣 
𪜿	亻 妟 
𪝙	亻 盍 
𪞓	冖 食 
𪞝	冫 𠬤 
𪞫	冫 敕 
𪞿	屯 刂 
𪟁	犮 刂 
𪟋	革 刂 
𪟍	𦚏 刂 
𪟣	吅 𠕁 力 
𪟪	北 不 
𪟲	匚 𫎬 
𪠀	𰇀 土 
𪠁	合 卩 
𪠏	厌 皮 
𪠑	厂 尃 
𪠚	厤 田 
𪠤	刀 又 
𪠥	又 月 
𪠦	圧 又 
𪠧	西 又 
𪠮	容 又 
𪠰	叕 刖 
𪡁	口 充 
𪡇	口 你 
𪡓	口 昆 
𪡛	口 门 可 
𪡶	口 冤 
𪢄	口 翌 
𪢋	口 亻 贾 
𪢥	口 邊 
𪢬	囗 昆 
𪢽	土 丰 
𪣗	辰 土 
𪣚	土 妟 
𪣝	土 皂 
𪣩	土 肯 
𪤉	土 𣳾 
𪤝	陽 土 
𪤯	土 亠 吕 羊 
𪥂	大 刀 
𪥅	大 戈 
𪥊	未 大 
𪥕	大 屈 
𪥠	贝 贝 贝 大 
𪥪	女 几 几 
𪥬	女 允 
𪥸	勿 好 
𪦕	女 爹 
𪦧	女 𤲥 
𪦳	女 𣍓 
𪧇	宀 爿 
𪧒	宀 佫 
𪧕	宀 土 缶 
𪧘	宀 娄 
𪧝	宀 弋 弋 火 
𪧥	宀 礻 缶 
𪧧	宀 臸 
𪧬	宀 酉 缶 
𪧭	宀 新 
𪧳	宀 來 厘 
𪧶	宀 柬 間 
𪨇	兀 贵 
𪨋	尸 𡈼 
𪨍	尸 伇 
𪨗	尸 彳 乔 
𪨘	尸 舛 口 
𪪋	𢆶 才 
𪪕	广 去 人 
𪪚	广 𦔻 
𪪝	广 邕 
𪪨	广 㐭 米 
𪪶	帝 廾 
𪪸	臼 辰 廾 
𪪹	冖 爵 廾 
𪪺	弓 口 
𪫂	弓 寅 
𪫅	弓 𩺰 
𪫎	彳 呚 
𪫐	彳 兔 
𪫖	彳 專 
𪫘	彳 止 口 止 
𪫠	比 心 
𪫡	忄 历 
𪫥	弔 心 
𪫰	吕 心 
𪫳	衣 心 
𪬚	忄 宾 
𪬹	忄 𫢀 
𪭊	戈 力 
𪭋	𢦏 子 
𪭍	共 戈 
𪭎	戈 甶 
𪭓	目 皿 戈 
𪭛	𫼉 亠 口 口 早 
𪭝	扌 韦 
𪭟	扌 午 
𪭢	扌 从 
𪭥	扌 左 
𪭧	扌 尔 
𪭪	扌 册 
𪭬	扌 𫯜 
𪭰	扌 羊 
𪭵	扌 两 
𪭶	扌 串 
𪮃	斩 手 
𪮋	扌 肃 
𪮟	扌 爹 
𪮡	扌 朗 
𪮤	扌 崩 
𪮪	扌 屚 
𪮰	扌 悶 
𪯈	夫 攵 
𪯌	𠂤 攵 
𪯍	更 攵 
𪯎	幸 攵 
𪯏	忽 攵 
𪯐	帝 攵 
𪯖	翏 攵 
𪯘	朁 攵 
𪯙	啻 攵 
𪯜	㐭 米 攵 
𪯢	文 文 
𪯨	产 初 
𪯱	斤 攵 
𪰄	𭤨 𬁅 
𪰅	𭤨 𦖞 
𪰍	日 斗 
𪰖	日 矢 
𪰸	日 素 
𪱖	日 隹 夬 
𪱛	尹 月 
𪱞	戈 二 月 
𪱢	胙 刂 
𪱪	月 𠔉 火 
𪱫	㲋 匕 月 
𪱳	木 口 
𪱷	木 贝 
𪲉	木 后 
𪲵	林 出 
𪳄	木 亮 
𪳅	木 洛 
𪳐	䀠 木 
𪳚	木 冖 東 
𪳯	林 坣 
𪳷	湯 木 
𪴕	木 層 
𪴩	方 欠 
𪴪	厈 欠 
𪴫	𡰥 欠 
𪴭	白 又 欠 
𪴴	羔 鬯 欠 
𪴵	勿 止 
𪴶	止 亘 
𪴸	止 土 必 
𪴿	與 止 
𪵁	歹 𠬢 
𪵇	歹 赖 
𪵉	口 土 殳 
𪵍	命 殳 
𪵹	氵 邛 
𪶄	氵 时 
𪶒	氵 罗 
𪶜	氵 拼 
𪶮	氵 恶 
𪶸	氵 紊 
𪶻	氵 次 月 
𪷚	氵 窜 
𪷽	氵 赞 
𪸅	氵 䌛 
𪸍	乙 火 
𪸒	火 互 
𪸬	火 戓 
𪸲	𤆌 召 
𪸺	火 昂 
𪹅	火 耐 
𪹇	火 炭 
𪹠	火 难 
𪹫	火 彭 
𪹹	火 阘 
𪺏	爫 豕 
𪺕	爫 幺 幺 幺 
𪺚	爫 魚 魚 魚 
𪺝	爻 牛 
𪺞	爿 言 
𪺟	爿 甾 
𪺣	片 寿 
𪺫	奶 牛 
𪺹	犭 奴 
𪺽	来 犬 
𪺾	犭 厓 
𪻐	𤣩 从 
𪼄	𤣩 袁 
𪽇	田 九 
𪽧	白 豆 疋 
𪽪	疒 长 
𪽰	疒 足 
𪽴	疒 贳 
𪽾	白 貝 
𪾇	皮 攵 
𪾌	可 皿 
𪾏	卣 皿 
𪾔	须 皿 
𪾕	月 𠔉 皿 
𪾘	鈚 皿 
𪾛	湄 火 皿 
𪾦	目 卢 
𪾪	目 次 
𪾾	目 答 
𫀂	十 入 示 
𫀉	礻 血 
𫀲	禾 克 
𫀸	禾 局 
𫁄	禾 消 
𫁍	穴 朱 
𫁐	穴 妙 
𫁘	穴 黽 
𫁡	立 鸟 
𫁤	立 刀 立 
𫁥	立 店 
𫁩	立 𦐇 
𫁳	竹 韦 
𫂀	竹 孛 
𫂈	竹 废 
𫂙	竹 敕 
𫂜	竹 𢼾 
𫂫	竹 阝 尊 
𫂾	米 因 
𫂿	杀 米 
𫃅	米 㐭 
𫃐	米 悶 
𫃑	米 勞 
𫃕	米 慈 
𫃗	米 韦 焦 
𫃜	糹 口 
𫃦	糸 且 又 
𫄇	糹 載 
𫄛	纟 今 
𫄝	纟 弔 
𫄟	纟 㐌 
𫄤	纟 达 
𫄥	纟 丽 
𫄦	纟 劫 
𫄩	纟 每 
𫄪	纟 丧 
𫄮	纟 盈 
𫄰	纟 旁 
𫄱	纟 啬 
𫄵	纟 彭 
𫄺	缶 呈 
𫅅	罒 齐 
𫅆	网 妻 
𫅈	罒 㢲 
𫅐	羊 央 
𫅙	羊 剛 
𫇏	至 來 
𫇓	𦥑 林 冖 酒 
𫇘	舌 赖 
𫈇	艹 皀 
𫈐	艹 幸 
𫈰	艹 洽 
𫈹	艹 大 車 
𫉁	艹 爱 
𫉏	艹 戈 邑 
𫉨	艹 禺 収 
𫉬	艹 犭 隻 
𫊈	蔡 丮 
𫊝	虍 口 
𫊣	虍 魚 
𫊪	虫 长 
𫊼	羽 虫 
𫋌	虫 贷 
𫋐	虫 貢 
𫋒	友 䖵 
𫋪	血 比 
𫌃	衤 丿 幺 龰 
𫌙	衤 簡 
𫌣	見 枼 
𫌩	见 句 
𫌲	言 廾 
𫌸	代 言 
𫍈	言 冘 臼 
𫍐	频 言 
𫍑	言 䧹 
𫍙	讠 也 
𫍛	讠 分 
𫍟	讠 㐌 
𫍠	讠 夗 
𫍢	讠 尧 
𫍩	讠 呙 
𫍫	讠 奄 
𫍶	讠 致 
𫍷	讠 鬼 
𫍺	讠 𡕩 
𫍻	讠 喜 
𫍼	讠 童 
𫎀	谷 人 
𫎇	䝉 一 
𫎉	柰 豕 
𫎎	丨 貝 丨 
𫎘	折 貝 
𫎛	氏 氏 貝 
𫎠	戸 臣 貝 
𫎢	貝 就 
𫎦	贝 龙 
𫎧	贝 句 
𫎱	走 历 
𫎸	走 斩 
𫎽	走 盍 
𫎿	走 爽 
𫏁	𧾷 一 䒑 
𫏇	𧾷 共 
𫏋	𧾷 乔 
𫏌	𧾷 来 
𫏐	斩 足 
𫏑	𧾷 罗 
𫏯	身 𣪘 
𫏷	車 止 土 
𫐃	車 田 爫 幺 又 車 田 
𫐖	车 翏 
𫐥	辶 老 
𫐻	辶 芻 
𫑈	辶 寓 
𫑍	辶 𠳋 攵 
𫑕	辶 童 㠯 
𫑛	戉 ⻏ 
𫑜	兆 ⻏ 
𫑩	羕 ⻏ 
𫑭	慶 ⻏ 
𫑰	龍 ⻏ 
𫑲	𬋺 ⻏ 
𫑴	酉 存 
𫒊	金 丰 
𫒌	金 介 
𫒏	金 皿 
𫒗	金 曳 
𫒘	金 缶 
𫒝	金 更 
𫒞	金 戒 
𫒡	金 𭻾 
𫒱	金 𪰖 
𫒶	金 凾 
𫒷	金 屋 
𫒽	金 炏 乂 
𫓇	金 棗 
𫓕	金 ？ 
𫓜	金 𦎫 
𫓞	金 林 㐭 
𫔘	門 丨 
𫔢	門 串 
𫔱	门 亦 
𫔽	阝 圣 
𫕃	阝 予 子 
𫕇	阝 夷 土 
𫕘	阝 彊 
𫕝	雨 𰆊 
𫕿	鴹 非 
𫖃	面 贵 
𫖍	韋 市 
𫖐	𠦄 本 𧘇 韋 
𫖓	韦 卑 
𫖔	韦 𤰇 
𫖖	韦 登 
𫖜	音 穆 
𫖞	斥 頁 
𫖪	𠂉 乁 页 
𫖬	页 㐱 
𫖰	多 页 
𫖲	员 页 
𫖴	责 页 
𫖵	岳 页 
𫖶	肩 页 
𫖺	樊 页 
𫗈	风 孛 
𫗉	风 奉 
𫗍	耂 食 
𫗗	飠 眉 
𫗚	渐 食 
𫗞	饣 干 
𫗟	饣 元 
𫗠	饣 长 
𫗡	饣 古 
𫗤	饣 大 女 
𫗦	饣 甫 
𫗨	饣 良 
𫗩	饣 罗 
𫗪	饣 委 
𫗫	饣 胡 
𫗮	饣 皇 
𫗰	饣 追 
𫗲	饣 斯 
𫗳	饣 强 
𫙆	𩰲 付 
𫙇	𩰲 冫 隹 冫 
𫙉	鬼 父 
𫙐	魚 廾 
𫙝	魚 𠔉 
𫚈	鱼 与 
𫚝	鱼 果 
𫚫	鱼 喿 
𫚸	鳥 有 
𫛛	支 鸟 
𫛞	鸟 夬 
𫛠	札 鸟 
𫛢	宁 鸟 
𫛣	鸟 穴 
𫛩	安 鸟 
𫛳	服 鸟 
𫛶	勅 鸟 
𫛸	是 鸟 
𫛹	眇 鸟 
𫜂	章 鸟 
𫜒	麦 它 
𫜕	𣪊 麦 
𫜞	黑 黽 
𫜢	鼠 一 
𫜣	鼠 登 
𫜦	齒 甫 
𫜨	齿 巴 
𫜫	齿 甫 
𫜷	寿 ⻏ 
𫜸	口 匕 
𫝂	一 ⺍ 丿 丅 
𫝃	一 ⺌ 冂 𠈌 
𫝄	丿 人 
𫝅	𠫓 人 
𫝆	亼 丆 
𫝇	亼 中 丶 
𫝈	亻 军 
𫝉	亼 君 
𫝊	亻 専 
𫝌	〢 朩 一 八 
𫝍	冂 丷 正 
𫝑	執 力 
𫝓	十 力 冫 𡿨 
𫝖	厃 ？ 
𫝗	厂 白 子 
𫝚	口 転 
𫝜	口 雑 
𫝝	𫩏 𠪚 
𫝞	口 霧 
𫝟	土 𫟯 
𫝠	土 覀 且 
𫝡	随 土 
𫝢	夕 十 丶 
𫝣	夕 𠀆 丶 
𫝤	龹 天 
𫝥	美 良 
𫝦	女 贝 
𫝧	女 岂 
𫝨	女 军 
𫝪	女 贡 
𫝫	女 来 
𫝮	女 阑 
𫝰	宀 亀 
𫝱	宓 罒 丁 
𫝲	尸 九 丶 
𫝳	山 弓 
𫝵	山 寿 
𫝶	广 㘴 
𫝷	广 𡊙 
𫝸	产 𫝄 
𫝹	𠆢 忈 
𫝼	扌 発 
𫞀	方 矣 
𫞂	日 玉 
𫞃	日 𠮦 
𫞄	一 从 一 日 
𫞅	月 寻 
𫞆	月 口 矢 
𫞇	月 鼡 
𫞉	木 𫝁 
𫞊	木 𠂆 方 
𫞌	木 𠂤 殳 
𫞍	木 覀 且 
𫞎	木 有 冋 
𫞐	木 龷 隹 
𫞒	木 暦 
𫞔	歹 𢦏 业 
𫞕	氏 丶 
𫞖	民 丶 
𫞚	氵 资 
𫞛	氵 诸 
𫞜	氵 业 𠕒 
𫞝	氵 阙 
𫞞	氵 艹 𫩏 隹 
𫞠	火 灵 
𫞡	火 荣 
𫞢	𰃮 牛 
𫞣	犭 戋 
𫞤	犭 𡊮 
𫞫	田 衣 
𫞬	疒 圣 
𫞯	乃 丶 皿 
𫞰	乃 㐅 皿 
𫞱	坮 皿 
𫞲	匕 目 大 
𫞶	礻 無 
𫞷	禾 会 
𫞹	穴 ユ 
𫞽	竹 𠀎 𧘇 
𫞾	竹 毘 
𫞿	竹 𭩮 
𫟀	米 雪 
𫟁	糹 𫨻 
𫟃	纟 任 
𫟄	纟 宏 
𫟆	纟 重 
𫟇	纟 廖 
𫟈	𦍌 𠆢 丷 
𫟉	耳 厶 
𫟎	艹 𠃤 
𫟏	艹 兎 
𫟐	艹 㝑 
𫟑	艹 灵 
𫟒	艹 𭩠 
𫟓	艹 𭇥 
𫟔	艹 欮 
𫟘	彳 𫝀 吊 亍 
𫟙	彳 吾 帀 亍 
𫟚	重 𧘇 
𫟜	艹 𫩏 隹 見 
𫟝	言 衣 𫩏 𠀎 
𫟞	讠 止 
𫟡	讠 宗 
𫟢	讠 贾 
𫟤	车 它 
𫟨	⻍ 土 衣 
𫟫	厉 ⻏ 
𫟬	质 ⻏ 
𫟭	客 ⻏ 
𫟰	金 当 
𫟱	金 士 日 寸 
𫟸	钅 式 
𫟺	钅 亥 
𫟽	钅 乖 
𫟾	钅 㚅 
𫠀	钅 厝 
𫠁	钅 蓋 
𫠂	门 令 
𫠃	⻖ 显 
𫠅	韦 革 
𫠇	风 文 
𫠈	风 必 
𫠋	马 鹿 
𫠏	鱼 木 
𫠒	鱼 章 
𫠔	夕 匕 鳥 
𫠕	广 隹 ？ 
𫠖	厷 鸟 
𫠗	卤 㑒 
𫠘	鼡 由 
𫠚	歯 句 
𫠥	𠃊 丙 
𫠦	一 丨 リ 亇 
𫡑	亻 从 
𫮬	土 强 
𫵒	尣 貴 
𫵘	尸 必 
𫼛	扌 弔 
𫼝	扌 刍 
𫽮	扌 党 
𬀷	𠂉 昜 
𬁠	日 乡 
𬄩	隐 木 
𬆛	歹 𡿺 
𬍙	𤣩 戋 
𬐚	𠂉 口 皿 
𬑔	罒 𧰨 
𬑗	目 间 
𬑡	目 芻 
𬒘	石 信 
𬓼	秃 贵 
𬘖	纟 见 
𬘜	纟 旦 
𬘝	纟 㐱 
𬘢	纟 光 
𬘵	纟 恒 
𬙆	纟 番 
𬛸	臼 工 
𬣀	彳 韦 亍 言 
𬤰	讠 雚 
𬧀	𧾷 将 
𬬫	钅 比 
𬬲	钅 爪 
𬬺	钅 且 
𬭣	钅 泉 
𬭲	钅 巢 
𬭴	钅 絜 
𬮤	门 合 
𬯅	⻖ 匚 夹 
𬰃	雨 沫 
𬱦	其 页 
𬲜	飠 牚 
𬳲	馬 羼 
𬳳	马 风 
𬴐	马 雚 
𬸅	刍 鸟 
𬸱	瞿 鸟 
𭀖	兀 丶 
𭕆	⺌ 贝 
𭘓	巾 无 
𭣇	扌 颠 
𭤰	𭤨 与 
𭪆	木 过 
𭱊	氵 项 
𭹜	𤣩 罗 
𮆏	竹 阑 
𮉡	纟 卢 
𮉢	纟 失 
𮉤	纟 圭 
𮉧	纟 两 
𮉪	纟 取 
𮉫	纟 委 
𮉬	纟 卒 
𮉯	纟 祭 
𮐨	艹 婴 
𮔂	虫 节 
𮔅	虫 负 
𮔊	虫 两 
𮖁	衤 两 
𮖱	衤 颉 
𮙊	讠 隐 
𮙋	读 言 
𮝴	车 瓜 
𮝵	车 而 
𮝸	车 盾 
𮝹	车 睘 
𮝺	车 葛 
𮠞	酉 仓 
𮣲	钅 工 
𮣳	钅 厷 
𮣵	钅 叕 
𮣷	钅 豦 
𮤲	门 必 
𮧴	韦 长 
𮧵	韦 华 
𮩛	饣 毕 
𮪣	马 㚇 
𮪥	马 敦 
𮫂	髟 宁 
𮬝	鱼 岁 
𮬞	𣦼 鱼 
𮬟	鱼 或 
𮬠	鱼 录 
𮬡	鱼 骨 
𮬢	鱼 翁 
𮬣	鱼 衔 
𮬤	鱼 箴 
𮭥	共 鸟 
𮭦	岑 鸟 
𮭨	晏 鸟 
𮭪	爽 鸟 
𮭰	卤 亢 
𮯙	齿 可 
𰃷	冫 仓 
𰗣	𠅃 木 
𰟘	火 阎 
𰧉	石 质 
𰱱	艹 资 
𰵝	讠 禾 
𰵴	讠 叔 
𰷠	贝 也 
𰷥	宗 贝 
𰻝	辶 穴 月 幺 长 言 马 幺 长 刂 心 
𰻞	辶 穴 月 幺 長 言 馬 幺 長 刂 心 
𱂨	安 页 
𱂯	卒 页 
𱂱	咸 页 
𱂻	焦 页 
𱃺	饣 舌 
𱅈	马 必 
𱉔	夬 鸟 
𱊈	兒 鸟